sample	chr	start	end	score	breakpoint	diff
2457_1	2	40483392	40483392	GA	40480536	2856
2457_1	11	35009024	35009024	GT	35006186	2838
2457_1	11	36036874	36036874	GT	36039406	2532
2457_1	11	37019716	37019716	GT	37024019	4303
2457_1	11	37702893	37702893	CG	37704795	1902
2457_1	14	106084734	106084734	GA	106085712	978
2457_1	2	40152389	40152389	GC	40151297	1092
2457_1	2	40152389	40152389	GC	40151586	803
2457_1	2	40195020	40195020	CG	40193822	1198
2457_1	2	40195266	40195266	CG	40193822	1444
2457_1	2	40195020	40195020	CG	40197371	2351
2457_1	2	40195266	40195266	CG	40197371	2105
2457_1	11	34993933	34993933	CT	34993932	1
2457_1	11	35794397	35794397	GA	35803073	8676
2457_1	11	35794397	35794397	GA	35803395	8998
2457_1	11	36036874	36036874	GT	36038844	1970
2457_1	11	36060588	36060588	CA	36068747	8159
2457_1	11	37019716	37019716	GT	37025052	5336
2457_1	12	9456910	9456910	CT	9464274	7364
2457_1	10	129653743	129653743	GC	129647150	6593
2457_1	11	34993933	34993933	CT	34999372	5439
2457_1	11	35009024	35009024	GT	34999372	9652
2457_1	2	40152389	40152389	GC	40152494	105
2457_1	2	40152389	40152389	GC	40151296	1093
2457_1	2	40423043	40423043	GT	40428475	5432
2457_1	2	40425454	40425454	GT	40428475	3021
2457_1	10	83488656	83488656	TC	83495702	7046
2457_1	2	216516019	216516019	GC	216514124	1895
2457_1	20	52271930	52271930	GA	52271524	406
2457_1	20	52274099	52274099	GT	52271524	2575
2457_3	2	40483392	40483392	GA	40480539	2853
2457_3	2	160344829	160344829	CT	160354010	9181
2457_3	3	55731676	55731676	CA	55731980	304
2457_3	11	35009024	35009024	GT	35006186	2838
2457_3	11	37019716	37019716	GT	37024019	4303
2457_3	11	37702893	37702893	CG	37704770	1877
2457_3	4	3561789	3561789	CT	3565686	3897
2457_3	14	106086698	106086698	CT	106085709	989
2457_3	14	106086698	106086698	CT	106089328	2630
2457_3	14	106086698	106086698	CT	106094221	7523
2457_3	22	18772224	18772224	GA	18778165	5941
2457_3	2	40152389	40152389	GC	40151297	1092
2457_3	2	40152389	40152389	GC	40151586	803
2457_3	2	40195020	40195020	CG	40193822	1198
2457_3	2	40195266	40195266	CG	40193822	1444
2457_3	2	40195020	40195020	CG	40197369	2349
2457_3	2	40195266	40195266	CG	40197369	2103
2457_3	7	29724001	29724001	AC	29714887	9114
2457_3	11	34993933	34993933	CT	34993932	1
2457_3	11	35083460	35083460	GA	35076239	7221
2457_3	11	35083460	35083460	GA	35082961	499
2457_3	11	35456003	35456003	GA	35464595	8592
2457_3	11	35794397	35794397	GA	35803073	8676
2457_3	11	35794397	35794397	GA	35803437	9040
2457_3	11	36060588	36060588	CA	36068759	8171
2457_3	11	37019716	37019716	GT	37025052	5336
2457_3	11	34993933	34993933	CT	34999372	5439
2457_3	11	35009024	35009024	GT	34999372	9652
2457_3	2	40152389	40152389	GC	40152573	184
2457_3	2	40152389	40152389	GC	40151582	807
2457_3	2	40152389	40152389	GC	40151296	1093
2457_3	2	40423043	40423043	GT	40421545	1498
2457_3	2	40425454	40425454	GT	40421545	3909
2457_3	2	40423043	40423043	GT	40428475	5432
2457_3	2	40425454	40425454	GT	40428475	3021
2821B	2	3277502	3277502	AG	3277782	280
2821B	5	104814801	104814801	GT	104805148	9653
2821B	8	91726960	91726960	AT	91729761	2801
2821B	8	91726960	91726960	AT	91730751	3791
2821B	8	91750271	91750271	AT	91757698	7427
2821B	8	91763608	91763608	GT	91757698	5910
2821B	8	91833539	91833539	AG	91831653	1886
2821B	8	94649608	94649608	CG	94650090	482
2821B	8	94649695	94649695	CG	94650090	395
2821B	8	94651652	94651652	GA	94650090	1562
2821B	11	59912129	59912129	GT	59919369	7240
2821B	11	59928843	59928843	GC	59919369	9474
2821B	11	108026095	108026095	CT	108035018	8923
2821B	17	67943188	67943188	GA	67943631	443
2821B	1	52354606	52354606	GT	52344798	9808
2821B	3	141960160	141960160	CA	141950175	9985
2821B	6	31908035	31908035	TC	31910047	2012
2821B	8	69699184	69699184	GC	69699091	93
2821B	8	69700042	69700042	GA	69699091	951
2821B	8	84499330	84499330	GC	84498628	702
2821B	8	91833539	91833539	AG	91833476	63
2821B	8	121315488	121315488	CA	121322977	7489
2821B	8	130664901	130664901	AC	130666995	2094
2821B	11	61350479	61350479	CT	61351356	877
2821B	1	202775457	202775457	GA	202768857	6600
2821B	1	223923779	223923779	TG	223923144	635
2821B	1	223927597	223927597	CG	223923144	4453
2821B	1	235668300	235668300	GT	235677834	9534
2821B	1	235786334	235786334	TC	235783446	2888
2821B	2	16055239	16055239	GT	16062804	7565
2821B	2	81507222	81507222	GA	81498458	8764
2821B	2	89875491	89875491	TA	89871625	3866
2821B	2	89876274	89876274	CG	89871625	4649
2821B	2	89879291	89879291	GA	89871625	7666
2821B	2	89875491	89875491	TA	89872093	3398
2821B	2	89876274	89876274	CG	89872093	4181
2821B	2	89879291	89879291	GA	89872093	7198
2821B	2	89875491	89875491	TA	89872675	2816
2821B	2	89876274	89876274	CG	89872675	3599
2821B	2	89879291	89879291	GA	89872675	6616
2821B	2	89875491	89875491	TA	89873332	2159
2821B	2	89876274	89876274	CG	89873332	2942
2821B	2	89879291	89879291	GA	89873332	5959
2821B	2	89875491	89875491	TA	89873556	1935
2821B	2	89876274	89876274	CG	89873556	2718
2821B	2	89879291	89879291	GA	89873556	5735
2821B	2	89875491	89875491	TA	89874032	1459
2821B	2	89876274	89876274	CG	89874032	2242
2821B	2	89879291	89879291	GA	89874032	5259
2821B	2	106678989	106678989	CT	106683527	4538
2821B	2	122076566	122076566	GT	122084240	7674
2821B	2	143985026	143985026	AG	143976367	8659
2821B	2	206310218	206310218	GA	206313620	3402
2821B	3	137112961	137112961	TA	137112997	36
2821B	3	137114408	137114408	CG	137112997	1411
2821B	5	29283139	29283139	TC	29292539	9400
2821B	5	101175061	101175061	CG	101175195	134
2821B	5	117578475	117578475	CT	117579092	617
2821B	5	117578477	117578477	CT	117579092	615
2821B	5	117578475	117578475	CT	117585972	7497
2821B	5	117578477	117578477	CT	117585972	7495
2821B	6	7030138	7030138	AG	7035297	5159
2821B	6	52510255	52510255	GA	52503986	6269
2821B	6	74163147	74163147	CG	74162855	292
2821B	7	47502385	47502385	TC	47502217	168
2821B	7	48910739	48910739	TA	48915684	4945
2821B	7	61545592	61545592	GA	61537769	7823
2821B	7	61545594	61545594	AC	61537769	7825
2821B	7	61545592	61545592	GA	61541927	3665
2821B	7	61545594	61545594	AC	61541927	3667
2821B	7	61545592	61545592	GA	61542207	3385
2821B	7	61545594	61545594	AC	61542207	3387
2821B	7	73510455	73510455	TC	73504716	5739
2821B	7	73510455	73510455	TC	73510310	145
2821B	8	51650673	51650673	CG	51652872	2199
2821B	8	83408741	83408741	CG	83416873	8132
2821B	8	83408741	83408741	CG	83416891	8150
2821B	8	86444783	86444783	CA	86441364	3419
2821B	8	90034160	90034160	CA	90040314	6154
2821B	8	90034827	90034827	CT	90040314	5487
2821B	8	91726960	91726960	AT	91730471	3511
2821B	8	91750271	91750271	AT	91747622	2649
2821B	8	91750271	91750271	AT	91750284	13
2821B	8	91833539	91833539	AG	91834202	663
2821B	8	97201414	97201414	CG	97202618	1204
2821B	8	104817574	104817574	GC	104825992	8418
2821B	8	104820093	104820093	CG	104825992	5899
2821B	8	127653778	127653778	CT	127648281	5497
2821B	8	130664901	130664901	AC	130664506	395
2821B	9	77438423	77438423	CT	77442193	3770
2821B	9	108581775	108581775	GC	108580480	1295
2821B	9	131240876	131240876	CG	131238812	2064
2821B	9	136952144	136952144	CA	136949379	2765
2821B	9	138066777	138066777	GT	138063546	3231
2821B	10	54459220	54459220	AG	54449266	9954
2821B	10	121094353	121094353	GA	121089173	5180
2821B	10	121289589	121289589	CT	121287591	1998
2821B	11	1569780	1569780	GC	1559985	9795
2821B	11	50693940	50693940	TC	50687673	6267
2821B	11	50693942	50693942	AC	50687673	6269
2821B	11	50693940	50693940	TC	50689508	4432
2821B	11	50693942	50693942	AC	50689508	4434
2821B	11	50693940	50693940	TC	50690056	3884
2821B	11	50693942	50693942	AC	50690056	3886
2821B	11	50693940	50693940	TC	50690599	3341
2821B	11	50693942	50693942	AC	50690599	3343
2821B	11	51237312	51237312	TA	51235732	1580
2821B	11	59928843	59928843	GC	59928414	429
2821B	11	59929520	59929520	CT	59928414	1106
2821B	11	61436760	61436760	GC	61432615	4145
2821B	11	61489753	61489753	GC	61481476	8277
2821B	11	62830460	62830460	GA	62838082	7622
2821B	11	62916463	62916463	CT	62924635	8172
2821B	11	62916621	62916621	CT	62924635	8014
2821B	11	62918016	62918016	GA	62924635	6619
2821B	11	62924725	62924725	CG	62924635	90
2821B	11	62924725	62924725	CG	62928696	3971
2821B	11	63348284	63348284	GC	63353340	5056
2821B	11	63356510	63356510	GA	63353340	3170
2821B	12	34493926	34493926	AC	34496333	2407
2821B	12	66951669	66951669	GT	66957304	5635
2821B	12	71322233	71322233	AG	71331945	9712
2821B	12	71331834	71331834	GT	71331945	111
2821B	12	71339545	71339545	TA	71331945	7600
2821B	12	111039342	111039342	GT	111031777	7565
2821B	12	133197689	133197689	GA	133203698	6009
2821B	14	34283917	34283917	GT	34280376	3541
2821B	14	52642870	52642870	CT	52646930	4060
2821B	14	74717593	74717593	GT	74719197	1604
2821B	14	91512768	91512768	TG	91516498	3730
2821B	16	58776882	58776882	GC	58776403	479
2821B	16	85809017	85809017	CG	85806067	2950
2821B	17	67943188	67943188	GA	67944116	928
2821B	19	2394545	2394545	TC	2401122	6577
2821B	19	3842834	3842834	GA	3841738	1096
2821B	19	3898828	3898828	CT	3902315	3487
2821B	19	19550611	19550611	CT	19552948	2337
2821B	19	27913564	27913564	GT	27910444	3120
2821B	19	27913565	27913565	TC	27910444	3121
2821B	19	47978989	47978989	GT	47985539	6550
2821B	19	49094411	49094411	CG	49098405	3994
2821B	19	53234561	53234561	TC	53234764	203
2821B	19	53234562	53234562	TC	53234764	202
2821B	19	55430716	55430716	AC	55423976	6740
2821B	20	22999920	22999920	CT	22994820	5100
2821B	20	23177034	23177034	CA	23168450	8584
2821B	20	31294868	31294868	GA	31286727	8141
2821B	20	33911429	33911429	GT	33910541	888
2821B	20	33911878	33911878	CG	33910541	1337
2821B	20	34393655	34393655	GT	34385422	8233
2821B	20	34393655	34393655	GT	34397640	3985
2821B	20	46227017	46227017	GA	46223161	3856
2821B	20	55026018	55026018	AT	55016115	9903
2821B	20	55462104	55462104	CA	55459523	2581
2821B	4	84446439	84446439	GT	84442266	4173
2821B	1	212810120	212810120	GA	212805464	4656
2821B	7	101458364	101458364	CT	101459454	1090
2821B	1	108746780	108746780	CG	108749142	2362
2821B	8	50172026	50172026	CG	50177345	5319
2821B	8	84499330	84499330	GC	84498229	1101
2821B	4	166352020	166352020	GA	166354190	2170
2821B	4	166352503	166352503	GC	166354190	1687
2821B	4	166352860	166352860	GA	166354190	1330
2821B	4	165443043	165443043	CT	165443318	275
2821B	8	81903176	81903176	CG	81903363	187
2821B	11	54992796	54992796	CA	54987427	5369
2821B	11	54997122	54997122	AC	54987427	9695
2821B	7	101458364	101458364	CT	101458925	561
2821B	11	56110691	56110691	TC	56102095	8596
2821B	11	61350479	61350479	CT	61351089	610
2821B	3	93680084	93680084	GC	93677964	2120
2821B	16	34775416	34775416	GC	34782182	6766
2821B	8	60754190	60754190	CT	60763739	9549
2821B	8	57318263	57318263	GC	57317901	362
2821B	8	57318556	57318556	GA	57317901	655
2821B	20	2586139	2586139	CG	2591380	5241
2821B	8	140728248	140728248	CT	140723724	4524
2821B	20	16119201	16119201	CG	16119380	179
2821B	8	81176509	81176509	CT	81175203	1306
2821B	20	18833492	18833492	CG	18831952	1540
2821B	20	33410832	33410832	GC	33405589	5243
2821B	20	33911429	33911429	GT	33901613	9816
3311A_1	3	189410197	189410197	CT	189402214	7983
3311A_1	3	189410197	189410197	CT	189405138	5059
3311A_3	1	17225647	17225647	GA	17216820	8827
4043A_1	2	13693749	13693749	AC	13698566	4817
4043A_1	3	66693037	66693037	TG	66698111	5074
4043A_1	6	65178216	65178216	CT	65178445	229
4043A_1	8	3821311	3821311	GA	3823539	2228
4043A_1	8	3821745	3821745	GA	3823539	1794
4043A_1	8	3822622	3822622	GA	3823539	917
4043A_1	8	3823313	3823313	GA	3823539	226
4043A_1	8	5237283	5237283	CA	5239075	1792
4043A_1	11	3090042	3090042	GA	3093309	3267
4043A_1	11	3090387	3090387	GA	3093309	2922
4043A_1	11	68743777	68743777	GC	68739355	4422
4043A_1	11	68743964	68743964	GT	68739355	4609
4043A_1	11	68744136	68744136	GC	68739355	4781
4043A_1	12	648079	648079	CT	640457	7622
4043A_1	12	4509973	4509973	TC	4501645	8328
4043A_1	12	27910895	27910895	AC	27907394	3501
4043A_1	12	28320704	28320704	CT	28320820	116
4043A_1	12	70566745	70566745	GA	70567500	755
4043A_1	12	100370880	100370880	CT	100379345	8465
4043A_1	12	100371268	100371268	CT	100379345	8077
4043A_1	12	100374036	100374036	CA	100379345	5309
4043A_1	16	7313578	7313578	GT	7323547	9969
4043A_1	16	7320484	7320484	GA	7323547	3063
4043A_1	16	7330705	7330705	GT	7323547	7158
4043A_1	16	7331138	7331138	GA	7323547	7591
4043A_1	16	7331338	7331338	GC	7323547	7791
4043A_1	16	7332660	7332660	GT	7323547	9113
4043A_1	16	7333010	7333010	GA	7323547	9463
4043A_1	16	7320484	7320484	GA	7323752	3268
4043A_1	16	7330705	7330705	GT	7323752	6953
4043A_1	16	7331138	7331138	GA	7323752	7386
4043A_1	16	7331338	7331338	GC	7323752	7586
4043A_1	16	7332660	7332660	GT	7323752	8908
4043A_1	16	7333010	7333010	GA	7323752	9258
4043A_1	18	52452751	52452751	CT	52448739	4012
4043A_1	18	52452751	52452751	CT	52448753	3998
4043A_1	18	52452751	52452751	CT	52449488	3263
4043A_1	18	52452751	52452751	CT	52460258	7507
4043A_1	18	57658143	57658143	GA	57667661	9518
4043A_1	18	57658766	57658766	GT	57667661	8895
4043A_1	18	57660408	57660408	GA	57667661	7253
4043A_1	18	57661518	57661518	GC	57667661	6143
4043A_1	18	57661773	57661773	GT	57667661	5888
4043A_1	18	57663519	57663519	GT	57667661	4142
4043A_1	18	57665244	57665244	GA	57667661	2417
4043A_1	18	57666060	57666060	CT	57667661	1601
4043A_1	18	57666061	57666061	AG	57667661	1600
4043A_1	18	57666491	57666491	GC	57667661	1170
4043A_1	18	57877131	57877131	AG	57886144	9013
4043A_1	18	59607676	59607676	GA	59617380	9704
4043A_1	18	59608956	59608956	GT	59617380	8424
4043A_1	18	59609127	59609127	GA	59617380	8253
4043A_1	18	59609727	59609727	GA	59617380	7653
4043A_1	18	59615748	59615748	GA	59617380	1632
4043A_1	18	59616071	59616071	GT	59617380	1309
4043A_1	18	59616748	59616748	GA	59617380	632
4043A_1	18	59624814	59624814	CA	59617380	7434
4043A_1	18	67176104	67176104	GA	67182975	6871
4043A_1	18	68157948	68157948	GA	68164051	6103
4043A_1	18	68158055	68158055	GA	68164051	5996
4043A_1	18	68158478	68158478	GA	68164051	5573
4043A_1	18	68158756	68158756	GA	68164051	5295
4043A_1	18	68158886	68158886	GC	68164051	5165
4043A_1	18	68159718	68159718	GA	68164051	4333
4043A_1	18	68160235	68160235	GC	68164051	3816
4043A_1	18	68161648	68161648	GA	68164051	2403
4043A_1	18	68162201	68162201	GC	68164051	1850
4043A_1	18	68162344	68162344	GA	68164051	1707
4043A_1	18	68162823	68162823	GA	68164051	1228
4043A_1	18	68164229	68164229	AG	68164051	178
4043A_1	19	3533477	3533477	GA	3534752	1275
4043A_1	19	3533669	3533669	GT	3534752	1083
4043A_1	X	28634645	28634645	GA	28637269	2624
4043A_1	X	28634936	28634936	GA	28637269	2333
4043A_1	X	73122806	73122806	CT	73129098	6292
4043A_1	X	73535722	73535722	AC	73527691	8031
4043A_1	X	75500493	75500493	GA	75501680	1187
4043A_1	X	75502189	75502189	GC	75501680	509
4043A_1	X	75505689	75505689	TG	75501680	4009
4043A_1	X	75500493	75500493	GA	75505936	5443
4043A_1	X	75502189	75502189	GC	75505936	3747
4043A_1	X	75505689	75505689	TG	75505936	247
4043A_1	X	78139625	78139625	AC	78143991	4366
4043A_1	X	78150321	78150321	CA	78143991	6330
4043A_1	X	78150371	78150371	CT	78143991	6380
4043A_1	X	78611536	78611536	GA	78613588	2052
4043A_1	X	78612206	78612206	GA	78613588	1382
4043A_1	X	78612735	78612735	GA	78613588	853
4043A_1	X	78773622	78773622	GA	78774370	748
4043A_1	X	124285593	124285593	GC	124289747	4154
4043A_1	X	131101093	131101093	CT	131102127	1034
4043A_1	2	146033614	146033614	AG	146033456	158
4043A_1	3	173702891	173702891	CT	173702579	312
4043A_1	3	173702891	173702891	CT	173702595	296
4043A_1	4	6448250	6448250	AG	6457550	9300
4043A_1	5	1777301	1777301	CG	1774688	2613
4043A_1	5	134695750	134695750	GT	134689049	6701
4043A_1	5	153190756	153190756	GT	153190722	34
4043A_1	6	32449306	32449306	GA	32440729	8577
4043A_1	6	65178216	65178216	CT	65178037	179
4043A_1	8	2638438	2638438	CG	2638217	221
4043A_1	8	3485160	3485160	GC	3482930	2230
4043A_1	8	3485255	3485255	GA	3482930	2325
4043A_1	8	3485644	3485644	GC	3482930	2714
4043A_1	8	3486127	3486127	GT	3482930	3197
4043A_1	8	3487797	3487797	GA	3482930	4867
4043A_1	8	3487936	3487936	GC	3482930	5006
4043A_1	8	3488293	3488293	GT	3482930	5363
4043A_1	8	3490845	3490845	GA	3482930	7915
4043A_1	9	22052086	22052086	CT	22051965	121
4043A_1	10	107956599	107956599	AC	107955524	1075
4043A_1	11	37524112	37524112	CT	37518215	5897
4043A_1	11	37525970	37525970	CT	37518215	7755
4043A_1	11	37527151	37527151	GA	37518215	8936
4043A_1	11	37527477	37527477	GC	37518215	9262
4043A_1	12	648079	648079	CT	647696	383
4043A_1	12	17058657	17058657	GC	17059300	643
4043A_1	12	27910895	27910895	AC	27907116	3779
4043A_1	12	27910895	27910895	AC	27907200	3695
4043A_1	12	28335830	28335830	CT	28335770	60
4043A_1	12	84879715	84879715	CG	84870817	8898
4043A_1	16	23672710	23672710	CT	23664873	7837
4043A_1	16	23674640	23674640	CT	23664873	9767
4043A_1	16	31356781	31356781	TC	31357940	1159
4043A_1	16	31359368	31359368	AC	31357940	1428
4043A_1	16	31359369	31359369	AC	31357940	1429
4043A_1	16	86167263	86167263	GA	86171530	4267
4043A_1	17	27314719	27314719	CT	27314164	555
4043A_1	17	38412389	38412389	AG	38412225	164
4043A_1	18	21069329	21069329	TA	21068381	948
4043A_1	18	57053688	57053688	CT	57051989	1699
4043A_1	18	57054445	57054445	CT	57051989	2456
4043A_1	18	57057910	57057910	CT	57051989	5921
4043A_1	18	58652625	58652625	GT	58644130	8495
4043A_1	18	59838440	59838440	GA	59841170	2730
4043A_1	18	59839986	59839986	GC	59841170	1184
4043A_1	18	59840899	59840899	GA	59841170	271
4043A_1	18	68061978	68061978	CT	68060061	1917
4043A_1	18	68062167	68062167	CT	68060061	2106
4043A_1	18	68062912	68062912	CT	68060061	2851
4043A_1	18	68064741	68064741	CG	68060061	4680
4043A_1	18	68066580	68066580	CG	68060061	6519
4043A_1	18	68066872	68066872	CG	68060061	6811
4043A_1	18	68068680	68068680	CT	68060061	8619
4043A_1	18	68069083	68069083	CT	68060061	9022
4043A_1	18	68157948	68157948	GA	68164027	6079
4043A_1	18	68158055	68158055	GA	68164027	5972
4043A_1	18	68158478	68158478	GA	68164027	5549
4043A_1	18	68158756	68158756	GA	68164027	5271
4043A_1	18	68158886	68158886	GC	68164027	5141
4043A_1	18	68159718	68159718	GA	68164027	4309
4043A_1	18	68160235	68160235	GC	68164027	3792
4043A_1	18	68161648	68161648	GA	68164027	2379
4043A_1	18	68162201	68162201	GC	68164027	1826
4043A_1	18	68162344	68162344	GA	68164027	1683
4043A_1	18	68162823	68162823	GA	68164027	1204
4043A_1	18	68164229	68164229	AG	68164027	202
4043A_1	X	66105235	66105235	GA	66108353	3118
4043A_1	X	66107359	66107359	GC	66108353	994
4043A_1	X	66107553	66107553	GA	66108353	800
4043A_1	X	73535722	73535722	AC	73530037	5685
4043A_1	X	78139625	78139625	AC	78142053	2428
4043A_1	X	78150321	78150321	CA	78142053	8268
4043A_1	X	78150371	78150371	CT	78142053	8318
4043A_1	X	80677492	80677492	GA	80677164	328
4043A_1	X	80678760	80678760	GT	80677164	1596
4043A_1	X	80679204	80679204	GA	80677164	2040
4043A_1	X	90544560	90544560	GT	90535902	8658
4043A_1	3	12622118	12622118	CT	12625597	3479
4043A_1	3	12624400	12624400	CT	12625597	1197
4043A_1	3	12624727	12624727	CT	12625597	870
4043A_1	3	31138281	31138281	GA	31132815	5466
4043A_1	3	31138560	31138560	GA	31132815	5745
4043A_1	3	59696017	59696017	GA	59691933	4084
4043A_1	3	59696019	59696019	GA	59691933	4086
4043A_1	3	66693037	66693037	TG	66697806	4769
4043A_1	3	173702891	173702891	CT	173703163	272
4043A_1	3	186786821	186786821	GA	186788422	1601
4043A_1	3	186788672	186788672	GA	186788422	250
4043A_1	3	186789280	186789280	GA	186788422	858
4043A_1	3	186789722	186789722	GC	186788422	1300
4043A_1	3	186789990	186789990	GA	186788422	1568
4043A_1	3	186790094	186790094	GA	186788422	1672
4043A_1	3	186790686	186790686	GA	186788422	2264
4043A_1	3	186790948	186790948	GA	186788422	2526
4043A_1	3	186791254	186791254	GA	186788422	2832
4043A_1	6	122050781	122050781	TC	122044097	6684
4043A_1	6	122105027	122105027	CG	122097906	7121
4043A_1	8	3821311	3821311	GA	3813335	7976
4043A_1	8	3821745	3821745	GA	3813335	8410
4043A_1	8	3822622	3822622	GA	3813335	9287
4043A_1	8	3823313	3823313	GA	3813335	9978
4043A_1	8	3821311	3821311	GA	3820855	456
4043A_1	8	3821745	3821745	GA	3820855	890
4043A_1	8	3822622	3822622	GA	3820855	1767
4043A_1	8	3823313	3823313	GA	3820855	2458
4043A_1	8	3821311	3821311	GA	3823968	2657
4043A_1	8	3821745	3821745	GA	3823968	2223
4043A_1	8	3822622	3822622	GA	3823968	1346
4043A_1	8	3823313	3823313	GA	3823968	655
4043A_1	10	46069896	46069896	GA	46073835	3939
4043A_1	10	46070582	46070582	GA	46073835	3253
4043A_1	10	46071212	46071212	GA	46073835	2623
4043A_1	10	46071373	46071373	GC	46073835	2462
4043A_1	10	46071548	46071548	GC	46073835	2287
4043A_1	10	46072529	46072529	GA	46073835	1306
4043A_1	10	46073364	46073364	GA	46073835	471
4043A_1	11	68743777	68743777	GC	68735825	7952
4043A_1	11	68743964	68743964	GT	68735825	8139
4043A_1	11	68744136	68744136	GC	68735825	8311
4043A_1	12	242246	242246	AG	249989	7743
4043A_1	12	27910895	27910895	AC	27907277	3618
4043A_1	12	27910895	27910895	AC	27909291	1604
4043A_1	12	55685330	55685330	CA	55685881	551
4043A_1	12	59473153	59473153	GT	59469843	3310
4043A_1	12	60095718	60095718	GA	60103938	8220
4043A_1	12	60100572	60100572	GA	60103938	3366
4043A_1	12	63186577	63186577	CA	63195549	8972
4043A_1	12	63187962	63187962	CT	63195549	7587
4043A_1	12	63190416	63190416	CT	63195549	5133
4043A_1	12	85619705	85619705	CA	85616777	2928
4043A_1	12	91804816	91804816	GC	91804096	720
4043A_1	12	91807083	91807083	GA	91804096	2987
4043A_1	12	91807424	91807424	GT	91804096	3328
4043A_1	12	91808125	91808125	GC	91804096	4029
4043A_1	12	110147124	110147124	GC	110143613	3511
4043A_1	12	118016361	118016361	CG	118016441	80
4043A_1	12	118023174	118023174	CT	118016441	6733
4043A_1	12	118025449	118025449	CT	118016441	9008
4043A_1	12	122733177	122733177	CT	122731287	1890
4043A_1	15	73118878	73118878	AG	73115855	3023
4043A_1	16	21739249	21739249	CT	21737205	2044
4043A_1	18	41332362	41332362	CG	41336176	3814
4043A_1	18	41335386	41335386	CG	41336176	790
4043A_1	18	41335907	41335907	CT	41336176	269
4043A_1	18	52452751	52452751	CT	52448542	4209
4043A_1	18	52452751	52452751	CT	52450509	2242
4043A_1	18	52452751	52452751	CT	52452916	165
4043A_1	18	52452751	52452751	CT	52453540	789
4043A_1	18	52452751	52452751	CT	52460014	7263
4043A_1	18	52452751	52452751	CT	52460173	7422
4043A_1	18	55146302	55146302	GT	55142654	3648
4043A_1	18	55146302	55146302	GT	55143016	3286
4043A_1	18	55146302	55146302	GT	55145495	807
4043A_1	18	57653422	57653422	GA	57652859	563
4043A_1	18	57654535	57654535	GA	57652859	1676
4043A_1	18	57655597	57655597	GC	57652859	2738
4043A_1	18	57656021	57656021	GA	57652859	3162
4043A_1	18	57658143	57658143	GA	57652859	5284
4043A_1	18	57658766	57658766	GT	57652859	5907
4043A_1	18	57660408	57660408	GA	57652859	7549
4043A_1	18	57661518	57661518	GC	57652859	8659
4043A_1	18	57661773	57661773	GT	57652859	8914
4043A_1	18	57653422	57653422	GA	57659722	6300
4043A_1	18	57654535	57654535	GA	57659722	5187
4043A_1	18	57655597	57655597	GC	57659722	4125
4043A_1	18	57656021	57656021	GA	57659722	3701
4043A_1	18	57658143	57658143	GA	57659722	1579
4043A_1	18	57658766	57658766	GT	57659722	956
4043A_1	18	57660408	57660408	GA	57659722	686
4043A_1	18	57661518	57661518	GC	57659722	1796
4043A_1	18	57661773	57661773	GT	57659722	2051
4043A_1	18	57663519	57663519	GT	57659722	3797
4043A_1	18	57665244	57665244	GA	57659722	5522
4043A_1	18	57666060	57666060	CT	57659722	6338
4043A_1	18	57666061	57666061	AG	57659722	6339
4043A_1	18	57666491	57666491	GC	57659722	6769
4043A_1	18	58652625	58652625	GT	58643515	9110
4043A_1	18	58736918	58736918	AG	58728806	8112
4043A_1	18	59838440	59838440	GA	59840432	1992
4043A_1	18	59839986	59839986	GC	59840432	446
4043A_1	18	59840899	59840899	GA	59840432	467
4043A_1	18	59838440	59838440	GA	59841323	2883
4043A_1	18	59839986	59839986	GC	59841323	1337
4043A_1	18	59840899	59840899	GA	59841323	424
4043A_1	18	62000351	62000351	CT	61999857	494
4043A_1	18	62004758	62004758	CT	61999857	4901
4043A_1	18	62005326	62005326	CA	61999857	5469
4043A_1	18	62007482	62007482	CT	61999857	7625
4043A_1	18	62008436	62008436	CT	61999857	8579
4043A_1	18	62008924	62008924	CT	61999857	9067
4043A_1	18	68157948	68157948	GA	68160861	2913
4043A_1	18	68158055	68158055	GA	68160861	2806
4043A_1	18	68158478	68158478	GA	68160861	2383
4043A_1	18	68158756	68158756	GA	68160861	2105
4043A_1	18	68158886	68158886	GC	68160861	1975
4043A_1	18	68159718	68159718	GA	68160861	1143
4043A_1	18	68160235	68160235	GC	68160861	626
4043A_1	18	68161648	68161648	GA	68160861	787
4043A_1	18	68162201	68162201	GC	68160861	1340
4043A_1	18	68162344	68162344	GA	68160861	1483
4043A_1	18	68162823	68162823	GA	68160861	1962
4043A_1	18	68164229	68164229	AG	68160861	3368
4043A_1	19	3217420	3217420	GA	3216392	1028
4043A_1	19	3217764	3217764	GA	3216392	1372
4043A_1	19	3644140	3644140	CT	3644441	301
4043A_1	21	23579712	23579712	CA	23579784	72
4043A_1	21	23579712	23579712	CA	23580527	815
4043A_1	X	30080897	30080897	CG	30077035	3862
4043A_1	X	65955745	65955745	GC	65955478	267
4043A_1	X	73912331	73912331	GA	73912638	307
4043A_1	X	73913331	73913331	GA	73912638	693
4043A_1	X	73916030	73916030	AG	73912638	3392
4043A_1	X	73916235	73916235	TA	73912638	3597
4043A_1	X	78139625	78139625	AC	78142015	2390
4043A_1	X	78150321	78150321	CA	78142015	8306
4043A_1	X	78150371	78150371	CT	78142015	8356
4043A_1	X	78139625	78139625	AC	78142259	2634
4043A_1	X	78150321	78150321	CA	78142259	8062
4043A_1	X	78150371	78150371	CT	78142259	8112
4043A_1	X	78150321	78150321	CA	78150337	16
4043A_1	X	78150371	78150371	CT	78150337	34
4043A_1	X	131101093	131101093	CT	131102147	1054
4043A_1	6	65178216	65178216	CT	65178027	189
4043A_1	3	87417900	87417900	CT	87414344	3556
4043A_1	8	3485160	3485160	GC	3483227	1933
4043A_1	8	3485255	3485255	GA	3483227	2028
4043A_1	8	3485644	3485644	GC	3483227	2417
4043A_1	8	3486127	3486127	GT	3483227	2900
4043A_1	8	3487797	3487797	GA	3483227	4570
4043A_1	8	3487936	3487936	GC	3483227	4709
4043A_1	8	3488293	3488293	GT	3483227	5066
4043A_1	8	3490845	3490845	GA	3483227	7618
4043A_1	8	3821311	3821311	GA	3821605	294
4043A_1	8	3821745	3821745	GA	3821605	140
4043A_1	8	3822622	3822622	GA	3821605	1017
4043A_1	8	3823313	3823313	GA	3821605	1708
4043A_1	3	186786821	186786821	GA	186793762	6941
4043A_1	3	186788672	186788672	GA	186793762	5090
4043A_1	3	186789280	186789280	GA	186793762	4482
4043A_1	3	186789722	186789722	GC	186793762	4040
4043A_1	3	186789990	186789990	GA	186793762	3772
4043A_1	3	186790094	186790094	GA	186793762	3668
4043A_1	3	186790686	186790686	GA	186793762	3076
4043A_1	3	186790948	186790948	GA	186793762	2814
4043A_1	3	186791254	186791254	GA	186793762	2508
4043A_1	7	62510168	62510168	CA	62510471	303
4043A_1	7	62510573	62510573	GC	62510471	102
4043A_1	8	3485160	3485160	GC	3492980	7820
4043A_1	8	3485255	3485255	GA	3492980	7725
4043A_1	8	3485644	3485644	GC	3492980	7336
4043A_1	8	3486127	3486127	GT	3492980	6853
4043A_1	8	3487797	3487797	GA	3492980	5183
4043A_1	8	3487936	3487936	GC	3492980	5044
4043A_1	8	3488293	3488293	GT	3492980	4687
4043A_1	8	3490845	3490845	GA	3492980	2135
4043A_1	8	3596387	3596387	AT	3595996	391
4043A_1	3	186786821	186786821	GA	186794050	7229
4043A_1	3	186788672	186788672	GA	186794050	5378
4043A_1	3	186789280	186789280	GA	186794050	4770
4043A_1	3	186789722	186789722	GC	186794050	4328
4043A_1	3	186789990	186789990	GA	186794050	4060
4043A_1	3	186790094	186790094	GA	186794050	3956
4043A_1	3	186790686	186790686	GA	186794050	3364
4043A_1	3	186790948	186790948	GA	186794050	3102
4043A_1	3	186791254	186791254	GA	186794050	2796
4043A_1	11	40569586	40569586	CG	40569794	208
4043A_1	12	27910895	27910895	AC	27907370	3525
4043A_1	12	27910895	27910895	AC	27909321	1574
4043A_1	12	63186577	63186577	CA	63196391	9814
4043A_1	12	63187962	63187962	CT	63196391	8429
4043A_1	12	63190416	63190416	CT	63196391	5975
4043A_1	11	281609	281609	GT	290602	8993
4043A_1	11	2918842	2918842	CT	2909002	9840
4043A_1	11	2918842	2918842	CT	2916459	2383
4043A_1	11	267825	267825	GA	267737	88
4043A_1	12	83561498	83561498	CT	83561745	247
4043A_1	12	85619705	85619705	CA	85617774	1931
4043A_1	11	2918842	2918842	CT	2915540	3302
4043A_1	11	281609	281609	GT	281805	196
4043A_1	12	100370880	100370880	CT	100379102	8222
4043A_1	12	100371268	100371268	CT	100379102	7834
4043A_1	12	100374036	100374036	CA	100379102	5066
4043A_1	12	118016361	118016361	CG	118015681	680
4043A_1	12	118023174	118023174	CT	118015681	7493
4043A_1	12	118025449	118025449	CT	118015681	9768
4043A_1	11	2918842	2918842	CT	2913545	5297
4043A_1	12	122709242	122709242	GA	122709677	435
4043A_1	11	281609	281609	GT	281452	157
4043A_1	12	122733177	122733177	CT	122729426	3751
4043A_1	5	115438747	115438747	TA	115441337	2590
4043A_1	11	58016799	58016799	GA	58021082	4283
4043A_1	11	58017012	58017012	GA	58021082	4070
4043A_1	11	58017222	58017222	GA	58021082	3860
4043A_1	11	58017447	58017447	GA	58021082	3635
4043A_1	11	58018111	58018111	GT	58021082	2971
4043A_1	3	31138281	31138281	GA	31133215	5066
4043A_1	3	31138560	31138560	GA	31133215	5345
4043A_1	3	31138281	31138281	GA	31133712	4569
4043A_1	3	31138560	31138560	GA	31133712	4848
4043A_1	16	6814352	6814352	AG	6823946	9594
4043A_1	3	31138281	31138281	GA	31133227	5054
4043A_1	3	31138560	31138560	GA	31133227	5333
4043A_1	16	7320484	7320484	GA	7324662	4178
4043A_1	16	7330705	7330705	GT	7324662	6043
4043A_1	16	7331138	7331138	GA	7324662	6476
4043A_1	16	7331338	7331338	GC	7324662	6676
4043A_1	16	7332660	7332660	GT	7324662	7998
4043A_1	16	7333010	7333010	GA	7324662	8348
4043A_1	16	7334368	7334368	GT	7324662	9706
4043A_1	16	8494280	8494280	GC	8492151	2129
4043A_1	16	8494712	8494712	GC	8492151	2561
4043A_1	16	8495027	8495027	GT	8492151	2876
4043A_1	16	8495817	8495817	GA	8492151	3666
4043A_1	14	105316575	105316575	GA	105317065	490
4043A_1	16	8566026	8566026	GT	8574372	8346
4043A_1	11	58016799	58016799	GA	58008513	8286
4043A_1	11	58017012	58017012	GA	58008513	8499
4043A_1	11	58017222	58017222	GA	58008513	8709
4043A_1	11	58017447	58017447	GA	58008513	8934
4043A_1	11	58018111	58018111	GT	58008513	9598
4043A_1	16	16011808	16011808	CG	16011594	214
4043A_1	16	16013449	16013449	CT	16011594	1855
4043A_1	11	60538525	60538525	CA	60540006	1481
4043A_1	11	60538877	60538877	CG	60540006	1129
4043A_1	11	60539819	60539819	CT	60540006	187
4043A_1	16	16011808	16011808	CG	16013466	1658
4043A_1	16	16013449	16013449	CT	16013466	17
4043A_1	11	56331515	56331515	CT	56329669	1846
4043A_1	11	56332518	56332518	CT	56329669	2849
4043A_1	11	56333502	56333502	CG	56329669	3833
4043A_1	11	56334599	56334599	CT	56329669	4930
4043A_1	11	56334910	56334910	CA	56329669	5241
4043A_1	11	56337172	56337172	CT	56329669	7503
4043A_1	11	56337437	56337437	CT	56329669	7768
4043A_1	11	56337654	56337654	CT	56329669	7985
4043A_1	12	123011480	123011480	GC	123019535	8055
4043A_1	12	123013869	123013869	GA	123019535	5666
4043A_1	12	123014246	123014246	GA	123019535	5289
4043A_1	12	123014715	123014715	GC	123019535	4820
4043A_1	12	123017396	123017396	GT	123019535	2139
4043A_1	12	123017624	123017624	GA	123019535	1911
4043A_1	16	21739249	21739249	CT	21736340	2909
4043A_1	16	21739249	21739249	CT	21736341	2908
4043A_1	3	175387699	175387699	CG	175389039	1340
4043A_1	18	41133579	41133579	CG	41135287	1708
4043A_1	3	177407646	177407646	GA	177411297	3651
4043A_1	3	177408264	177408264	GA	177411297	3033
4043A_1	3	177409937	177409937	GA	177411297	1360
4043A_1	18	41332362	41332362	CG	41337786	5424
4043A_1	18	41335386	41335386	CG	41337786	2400
4043A_1	18	41335907	41335907	CT	41337786	1879
4043A_1	18	45599555	45599555	CG	45600597	1042
4043A_1	18	45599775	45599775	CT	45600597	822
4043A_1	18	45600112	45600112	CA	45600597	485
4043A_1	18	52452751	52452751	CT	52448564	4187
4043A_1	18	52452751	52452751	CT	52448680	4071
4043A_1	12	27910895	27910895	AC	27911074	179
4043A_1	18	52452751	52452751	CT	52448724	4027
4043A_1	12	27910895	27910895	AC	27903289	7606
4043A_1	18	52452751	52452751	CT	52448731	4020
4043A_1	12	27910895	27910895	AC	27910889	6
4043A_1	18	52452751	52452751	CT	52448743	4008
4043A_1	12	27910895	27910895	AC	27909299	1596
4043A_1	18	52452751	52452751	CT	52449378	3373
4043A_1	18	52452751	52452751	CT	52449537	3214
4043A_1	18	52452751	52452751	CT	52452052	699
4043A_1	12	27910895	27910895	AC	27912232	1337
4043A_1	18	52452751	52452751	CT	52459054	6303
4043A_1	12	27910895	27910895	AC	27913305	2410
4043A_1	18	52452751	52452751	CT	52459566	6815
4043A_1	18	52452751	52452751	CT	52460096	7345
4043A_1	3	173702891	173702891	CT	173703142	251
4043A_1	18	55146302	55146302	GT	55143336	2966
4043A_1	3	173702891	173702891	CT	173702554	337
4043A_1	18	55146302	55146302	GT	55143756	2546
4043A_1	3	173702891	173702891	CT	173703053	162
4043A_1	18	57658143	57658143	GA	57667334	9191
4043A_1	18	57658766	57658766	GT	57667334	8568
4043A_1	18	57660408	57660408	GA	57667334	6926
4043A_1	18	57661518	57661518	GC	57667334	5816
4043A_1	18	57661773	57661773	GT	57667334	5561
4043A_1	18	57663519	57663519	GT	57667334	3815
4043A_1	18	57665244	57665244	GA	57667334	2090
4043A_1	18	57666060	57666060	CT	57667334	1274
4043A_1	18	57666061	57666061	AG	57667334	1273
4043A_1	18	57666491	57666491	GC	57667334	843
4043A_1	18	61910607	61910607	AT	61914058	3451
4043A_1	16	7320484	7320484	GA	7323804	3320
4043A_1	16	7330705	7330705	GT	7323804	6901
4043A_1	16	7331138	7331138	GA	7323804	7334
4043A_1	16	7331338	7331338	GC	7323804	7534
4043A_1	16	7332660	7332660	GT	7323804	8856
4043A_1	16	7333010	7333010	GA	7323804	9206
4043A_1	3	173702891	173702891	CT	173703087	196
4043A_1	12	27910895	27910895	AC	27903124	7771
4043A_1	12	27910895	27910895	AC	27912908	2013
4043A_1	12	27910895	27910895	AC	27910924	29
4043A_1	12	27910895	27910895	AC	27907319	3576
4043A_1	12	27910895	27910895	AC	27910888	7
4043A_1	12	27910895	27910895	AC	27910985	90
4043A_1	12	27910895	27910895	AC	27913114	2219
4043A_1	18	68386602	68386602	GT	68392703	6101
4043A_1	18	68386602	68386602	GT	68392705	6103
4043A_1	18	69461444	69461444	CT	69461191	253
4043A_1	18	69464731	69464731	CA	69461191	3540
4043A_1	18	69465330	69465330	CG	69461191	4139
4043A_1	18	69466264	69466264	CT	69461191	5073
4043A_1	18	69466359	69466359	CT	69461191	5168
4043A_1	18	69470059	69470059	CG	69461191	8868
4043A_1	18	69470255	69470255	CT	69461191	9064
4043A_1	18	73206507	73206507	CG	73214296	7789
4043A_1	18	73206924	73206924	CT	73214296	7372
4043A_1	18	73206925	73206925	CG	73214296	7371
4043A_1	18	77690728	77690728	GA	77690044	684
4043A_1	18	77691012	77691012	GA	77690044	968
4043A_1	18	77691764	77691764	GT	77690044	1720
4043A_1	18	77690728	77690728	GA	77690283	445
4043A_1	18	77691012	77691012	GA	77690283	729
4043A_1	18	77691764	77691764	GT	77690283	1481
4043A_1	11	267825	267825	GA	268203	378
4043A_1	19	3217420	3217420	GA	3215722	1698
4043A_1	19	3217764	3217764	GA	3215722	2042
4043A_1	19	3217420	3217420	GA	3219122	1702
4043A_1	19	3217764	3217764	GA	3219122	1358
4043A_1	19	3644140	3644140	CT	3642859	1281
4043A_1	1	142656625	142656625	AC	142648143	8482
4043A_1	19	29660380	29660380	GA	29661197	817
4043A_1	3	65149295	65149295	CA	65151100	1805
4043A_1	19	30317342	30317342	AT	30321692	4350
4043A_1	19	30330565	30330565	CT	30321692	8873
4043A_1	19	30330697	30330697	CT	30321692	9005
4043A_1	19	30351938	30351938	TC	30349282	2656
4043A_1	3	31138281	31138281	GA	31139142	861
4043A_1	3	31138560	31138560	GA	31139142	582
4043A_1	11	60538525	60538525	CA	60537662	863
4043A_1	11	60538877	60538877	CG	60537662	1215
4043A_1	11	60539819	60539819	CT	60537662	2157
4043A_1	6	66533378	66533378	CT	66537979	4601
4043A_1	18	68454939	68454939	TG	68461078	6139
4043A_1	3	124041429	124041429	CT	124042743	1314
4043A_1	5	63683138	63683138	GC	63674531	8607
4043A_1	20	10451385	10451385	GA	10451127	258
4043A_1	20	10451495	10451495	GA	10451127	368
4043A_1	20	20294390	20294390	TG	20302253	7863
4043A_1	20	37034405	37034405	GC	37033652	753
4043A_1	16	7270322	7270322	CA	7262411	7911
4043A_1	X	28634645	28634645	GA	28635117	472
4043A_1	X	28634936	28634936	GA	28635117	181
4043A_1	X	28634645	28634645	GA	28637275	2630
4043A_1	X	28634936	28634936	GA	28637275	2339
4043A_1	X	34442126	34442126	CA	34441952	174
4043A_1	X	34445093	34445093	GA	34441952	3141
4043A_1	X	34446713	34446713	GA	34441952	4761
4043A_1	6	65178216	65178216	CT	65178468	252
4043A_1	X	34446713	34446713	GA	34455118	8405
4043A_1	X	34453999	34453999	TC	34455118	1119
4043A_1	6	65178216	65178216	CT	65178153	63
4043A_1	18	34967900	34967900	CT	34973041	5141
4043A_1	18	34969272	34969272	CT	34973041	3769
4043A_1	18	34969869	34969869	TA	34973041	3172
4043A_1	18	34970215	34970215	CG	34973041	2826
4043A_1	18	34970392	34970392	CG	34973041	2649
4043A_1	18	34970532	34970532	CT	34973041	2509
4043A_1	18	34971010	34971010	CT	34973041	2031
4043A_1	18	34971220	34971220	CT	34973041	1821
4043A_1	18	34971441	34971441	CA	34973041	1600
4043A_1	18	34972533	34972533	CA	34973041	508
4043A_1	6	65178216	65178216	CT	65178331	115
4043A_1	X	69355858	69355858	GC	69357846	1988
4043A_1	X	69356065	69356065	GT	69357846	1781
4043A_1	6	65178216	65178216	CT	65178469	253
4043A_1	18	77690728	77690728	GA	77692030	1302
4043A_1	18	77691012	77691012	GA	77692030	1018
4043A_1	18	77691764	77691764	GT	77692030	266
4043A_1	16	7313578	7313578	GT	7313033	545
4043A_1	16	7320484	7320484	GA	7313033	7451
4043A_1	X	73122806	73122806	CT	73128010	5204
4043A_1	X	73122806	73122806	CT	73128156	5350
4043A_1	X	73535722	73535722	AC	73527406	8316
4043A_1	X	73897576	73897576	GC	73901416	3840
4043A_1	20	12867945	12867945	CG	12865436	2509
4043A_1	X	73912331	73912331	GA	73911571	760
4043A_1	X	73913331	73913331	GA	73911571	1760
4043A_1	X	73916030	73916030	AG	73911571	4459
4043A_1	X	73916235	73916235	TA	73911571	4664
4043A_1	X	73912331	73912331	GA	73912724	393
4043A_1	X	73913331	73913331	GA	73912724	607
4043A_1	X	73916030	73916030	AG	73912724	3306
4043A_1	X	73916235	73916235	TA	73912724	3511
4043A_1	18	68402967	68402967	GA	68404676	1709
4043A_1	18	68386602	68386602	GT	68392558	5956
4043A_1	X	74330237	74330237	CG	74332219	1982
4043A_1	X	74331837	74331837	CT	74332219	382
4043A_1	3	160574640	160574640	CG	160574764	124
4043A_1	16	21739249	21739249	CT	21736816	2433
4043A_1	X	75500493	75500493	GA	75498212	2281
4043A_1	X	75502189	75502189	GC	75498212	3977
4043A_1	X	75505689	75505689	TG	75498212	7477
4043A_1	X	77643349	77643349	CT	77648578	5229
4043A_1	X	77643822	77643822	CT	77648578	4756
4043A_1	X	77684185	77684185	GC	77684095	90
4043A_1	11	55586265	55586265	GC	55586981	716
4043A_1	X	78342718	78342718	GA	78342539	179
4043A_1	X	78342718	78342718	GA	78342552	166
4043A_1	18	52751044	52751044	TG	52748595	2449
4043A_1	6	66505017	66505017	CT	66512652	7635
4043A_1	16	8494280	8494280	GC	8493456	824
4043A_1	16	8494712	8494712	GC	8493456	1256
4043A_1	16	8495027	8495027	GT	8493456	1571
4043A_1	16	8495817	8495817	GA	8493456	2361
4043A_1	X	78611536	78611536	GA	78605483	6053
4043A_1	X	78612206	78612206	GA	78605483	6723
4043A_1	X	78612735	78612735	GA	78605483	7252
4043A_1	X	78611536	78611536	GA	78610628	908
4043A_1	X	78612206	78612206	GA	78610628	1578
4043A_1	X	78612735	78612735	GA	78610628	2107
4043A_1	X	78611536	78611536	GA	78610644	892
4043A_1	X	78612206	78612206	GA	78610644	1562
4043A_1	X	78612735	78612735	GA	78610644	2091
4043A_1	X	78686948	78686948	CA	78681541	5407
4043A_1	X	78773622	78773622	GA	78772853	769
4043A_1	3	87417900	87417900	CT	87413325	4575
4043A_1	X	78773622	78773622	GA	78777355	3733
4043A_1	6	65178216	65178216	CT	65178147	69
4043A_1	X	79544946	79544946	CG	79547983	3037
4043A_1	8	3485160	3485160	GC	3490815	5655
4043A_1	8	3485255	3485255	GA	3490815	5560
4043A_1	8	3485644	3485644	GC	3490815	5171
4043A_1	8	3486127	3486127	GT	3490815	4688
4043A_1	8	3487797	3487797	GA	3490815	3018
4043A_1	8	3487936	3487936	GC	3490815	2879
4043A_1	8	3488293	3488293	GT	3490815	2522
4043A_1	8	3490845	3490845	GA	3490815	30
4043A_1	6	65178216	65178216	CT	65177929	287
4043A_1	X	81211431	81211431	CT	81208313	3118
4043A_1	X	81212195	81212195	CT	81208313	3882
4043A_1	X	81263147	81263147	GC	81262727	420
4043A_1	X	81263905	81263905	GA	81262727	1178
4043A_1	X	81264080	81264080	GC	81262727	1353
4043A_1	X	81264407	81264407	GT	81262727	1680
4043A_1	X	81265020	81265020	GT	81262727	2293
4043A_1	X	81265123	81265123	GA	81262727	2396
4043A_1	6	65178216	65178216	CT	65178520	304
4043A_1	X	81287039	81287039	GA	81287598	559
4043A_1	X	81759351	81759351	GA	81760929	1578
4043A_1	X	81759777	81759777	GT	81760929	1152
4043A_1	14	106053021	106053021	GT	106051605	1416
4043A_1	14	106054237	106054237	GA	106051605	2632
4043A_1	14	106054541	106054541	GA	106051605	2936
4043A_1	14	106055160	106055160	GA	106051605	3555
4043A_1	14	106057741	106057741	GC	106051605	6136
4043A_1	14	106058012	106058012	GA	106051605	6407
4043A_1	14	106061092	106061092	TC	106051605	9487
4043A_1	14	106061093	106061093	GT	106051605	9488
4043A_1	X	85023411	85023411	GA	85023373	38
4043A_1	X	85024343	85024343	GT	85023373	970
4043A_1	X	85024444	85024444	GC	85023373	1071
4043A_1	X	85024725	85024725	AG	85023373	1352
4043A_1	11	56331515	56331515	CT	56335919	4404
4043A_1	11	56332518	56332518	CT	56335919	3401
4043A_1	11	56333502	56333502	CG	56335919	2417
4043A_1	11	56334599	56334599	CT	56335919	1320
4043A_1	11	56334910	56334910	CA	56335919	1009
4043A_1	11	56337172	56337172	CT	56335919	1253
4043A_1	11	56337437	56337437	CT	56335919	1518
4043A_1	11	56337654	56337654	CT	56335919	1735
4043A_1	11	56343066	56343066	TA	56335919	7147
4043A_1	X	85253318	85253318	CT	85250949	2369
4043A_1	X	85253318	85253318	CT	85251753	1565
4043A_1	11	56331515	56331515	CT	56334977	3462
4043A_1	11	56332518	56332518	CT	56334977	2459
4043A_1	11	56333502	56333502	CG	56334977	1475
4043A_1	11	56334599	56334599	CT	56334977	378
4043A_1	11	56334910	56334910	CA	56334977	67
4043A_1	11	56337172	56337172	CT	56334977	2195
4043A_1	11	56337437	56337437	CT	56334977	2460
4043A_1	11	56337654	56337654	CT	56334977	2677
4043A_1	11	56343066	56343066	TA	56334977	8089
4043A_1	3	85137600	85137600	GA	85137876	276
4043A_1	X	86306442	86306442	GA	86313487	7045
4043A_1	X	86309301	86309301	GA	86313487	4186
4043A_1	X	86311614	86311614	GA	86313487	1873
4043A_1	X	86312564	86312564	GA	86313487	923
4043A_1	16	21739249	21739249	CT	21736775	2474
4043A_1	X	86306442	86306442	GA	86313491	7049
4043A_1	X	86309301	86309301	GA	86313491	4190
4043A_1	X	86311614	86311614	GA	86313491	1877
4043A_1	X	86312564	86312564	GA	86313491	927
4043A_1	16	21739249	21739249	CT	21738705	544
4043A_1	X	86369230	86369230	CT	86363119	6111
4043A_1	18	28433244	28433244	GT	28430660	2584
4043A_1	6	65178216	65178216	CT	65178433	217
4043A_1	X	124285593	124285593	GC	124288910	3317
4043A_1	X	126838701	126838701	CA	126838797	96
4043A_1	12	242246	242246	AG	242054	192
4043A_1	X	151704532	151704532	GC	151708515	3983
4043A_1	X	151705598	151705598	GA	151708515	2917
4043A_1	X	151706318	151706318	GA	151708515	2197
4043A_1	X	153650289	153650289	CT	153650162	127
4043A_1	X	153659659	153659659	CT	153650162	9497
4043A_1	X	153650289	153650289	CT	153650283	6
4043A_1	X	153659659	153659659	CT	153650283	9376
4043A_1	X	153650289	153650289	CT	153650462	173
4043A_1	X	153659659	153659659	CT	153650462	9197
4043A_1	X	153650289	153650289	CT	153650632	343
4043A_1	X	153659659	153659659	CT	153650632	9027
4043A_1	X	153660585	153660585	CT	153650632	9953
4043A_1	X	153650289	153650289	CT	153659981	9692
4043A_1	X	153659659	153659659	CT	153659981	322
4043A_1	X	153660585	153660585	CT	153659981	604
4043A_1	X	153661014	153661014	CG	153659981	1033
4043A_1	X	153661428	153661428	CA	153659981	1447
4043A_1	X	153662080	153662080	CT	153659981	2099
4043A_1	X	153662664	153662664	CG	153659981	2683
4043A_1	X	153663071	153663071	CA	153659981	3090
4043A_1	X	153663179	153663179	CG	153659981	3198
4043A_1	X	153663627	153663627	CG	153659981	3646
4043A_1	X	153663824	153663824	CT	153659981	3843
4043A_1	8	7005759	7005759	GC	7005436	323
4043A_1	8	7006410	7006410	GA	7005436	974
4043A_1	X	153900688	153900688	CG	153899478	1210
4043A_1	X	153901556	153901556	CT	153899478	2078
4043A_1	X	153901557	153901557	CT	153899478	2079
4043A_1	X	153900688	153900688	CG	153900471	217
4043A_1	X	153901556	153901556	CT	153900471	1085
4043A_1	X	153901557	153901557	CT	153900471	1086
4043A_1	X	153900688	153900688	CG	153900473	215
4043A_1	X	153901556	153901556	CT	153900473	1083
4043A_1	X	153901557	153901557	CT	153900473	1084
4043A_4	2	13693749	13693749	AC	13698566	4817
4043A_4	3	66693037	66693037	TG	66698111	5074
4043A_4	3	173702891	173702891	CT	173703034	143
4043A_4	3	186355069	186355069	GA	186351170	3899
4043A_4	6	65178216	65178216	CT	65178445	229
4043A_4	8	3821311	3821311	GA	3823539	2228
4043A_4	8	3821745	3821745	GA	3823539	1794
4043A_4	8	3823313	3823313	GA	3823539	226
4043A_4	8	5237283	5237283	CA	5239241	1958
4043A_4	8	5237283	5237283	CA	5240049	2766
4043A_4	11	3090042	3090042	GA	3093309	3267
4043A_4	11	3090387	3090387	GA	3093309	2922
4043A_4	12	4509973	4509973	TC	4501645	8328
4043A_4	12	27910895	27910895	AC	27904127	6768
4043A_4	12	27910895	27910895	AC	27907394	3501
4043A_4	12	28320704	28320704	CT	28320820	116
4043A_4	12	34465926	34465926	CA	34456769	9157
4043A_4	12	70566745	70566745	GA	70567500	755
4043A_4	12	100370880	100370880	CT	100379345	8465
4043A_4	12	100371268	100371268	CT	100379345	8077
4043A_4	12	100374036	100374036	CA	100379345	5309
4043A_4	16	7320484	7320484	GA	7323752	3268
4043A_4	16	7329738	7329738	GA	7323752	5986
4043A_4	16	7330705	7330705	GT	7323752	6953
4043A_4	16	7331138	7331138	GA	7323752	7386
4043A_4	16	7331338	7331338	GC	7323752	7586
4043A_4	16	7332660	7332660	GT	7323752	8908
4043A_4	16	7333010	7333010	GA	7323752	9258
4043A_4	16	86167263	86167263	GA	86171766	4503
4043A_4	18	52452751	52452751	CT	52448739	4012
4043A_4	18	52452751	52452751	CT	52448753	3998
4043A_4	18	52452751	52452751	CT	52458711	5960
4043A_4	18	52452751	52452751	CT	52459758	7007
4043A_4	18	52452751	52452751	CT	52460183	7432
4043A_4	18	52452751	52452751	CT	52460258	7507
4043A_4	18	56966539	56966539	CT	56971627	5088
4043A_4	18	56966916	56966916	GA	56971627	4711
4043A_4	18	56967056	56967056	GA	56971627	4571
4043A_4	18	57658143	57658143	GA	57667658	9515
4043A_4	18	57658766	57658766	GT	57667658	8892
4043A_4	18	57660408	57660408	GA	57667658	7250
4043A_4	18	57661518	57661518	GC	57667658	6140
4043A_4	18	57661773	57661773	GT	57667658	5885
4043A_4	18	57663519	57663519	GT	57667658	4139
4043A_4	18	57665244	57665244	GA	57667658	2414
4043A_4	18	57666060	57666060	CT	57667658	1598
4043A_4	18	57666061	57666061	AG	57667658	1597
4043A_4	18	57666491	57666491	GC	57667658	1167
4043A_4	18	59607676	59607676	GA	59617380	9704
4043A_4	18	59608956	59608956	GT	59617380	8424
4043A_4	18	59609127	59609127	GA	59617380	8253
4043A_4	18	59615748	59615748	GA	59617380	1632
4043A_4	18	59616071	59616071	GT	59617380	1309
4043A_4	18	59616748	59616748	GA	59617380	632
4043A_4	18	59624814	59624814	CA	59617380	7434
4043A_4	18	59709089	59709089	CG	59709145	56
4043A_4	18	67176104	67176104	GA	67182975	6871
4043A_4	18	68155238	68155238	GT	68164051	8813
4043A_4	18	68158478	68158478	GA	68164051	5573
4043A_4	18	68159718	68159718	GA	68164051	4333
4043A_4	18	68160235	68160235	GC	68164051	3816
4043A_4	18	68161648	68161648	GA	68164051	2403
4043A_4	18	68162823	68162823	GA	68164051	1228
4043A_4	19	3532949	3532949	GA	3534752	1803
4043A_4	19	3533072	3533072	GA	3534752	1680
4043A_4	19	3533477	3533477	GA	3534752	1275
4043A_4	19	3533669	3533669	GT	3534752	1083
4043A_4	X	28634645	28634645	GA	28637273	2628
4043A_4	X	28634936	28634936	GA	28637273	2337
4043A_4	X	73122806	73122806	CT	73129098	6292
4043A_4	X	73535722	73535722	AC	73527691	8031
4043A_4	X	75500493	75500493	GA	75505936	5443
4043A_4	X	75502189	75502189	GC	75505936	3747
4043A_4	X	75505689	75505689	TG	75505936	247
4043A_4	X	78611536	78611536	GA	78613588	2052
4043A_4	X	78612206	78612206	GA	78613588	1382
4043A_4	X	78612735	78612735	GA	78613588	853
4043A_4	X	78773622	78773622	GA	78774370	748
4043A_4	X	124285593	124285593	GC	124289747	4154
4043A_4	X	131101093	131101093	CT	131102127	1034
4043A_4	1	149316771	149316771	TC	149313571	3200
4043A_4	2	97858734	97858734	AG	97860493	1759
4043A_4	2	146033614	146033614	AG	146033456	158
4043A_4	3	173702891	173702891	CT	173702579	312
4043A_4	3	192428338	192428338	GA	192427804	534
4043A_4	4	63257268	63257268	AT	63257225	43
4043A_4	5	134695750	134695750	GT	134689049	6701
4043A_4	6	65178216	65178216	CT	65178037	179
4043A_4	6	121717540	121717540	GA	121716418	1122
4043A_4	6	162697414	162697414	TC	162688597	8817
4043A_4	8	2638438	2638438	CG	2638217	221
4043A_4	8	3485160	3485160	GC	3482930	2230
4043A_4	8	3485255	3485255	GA	3482930	2325
4043A_4	8	3485644	3485644	GC	3482930	2714
4043A_4	8	3486127	3486127	GT	3482930	3197
4043A_4	8	3487797	3487797	GA	3482930	4867
4043A_4	8	3487936	3487936	GC	3482930	5006
4043A_4	8	3488293	3488293	GT	3482930	5363
4043A_4	8	3490845	3490845	GA	3482930	7915
4043A_4	8	5237283	5237283	CA	5239878	2595
4043A_4	8	117145528	117145528	AG	117145463	65
4043A_4	9	22052086	22052086	CT	22051965	121
4043A_4	11	37524112	37524112	CT	37518215	5897
4043A_4	11	37525970	37525970	CT	37518215	7755
4043A_4	11	37527151	37527151	GA	37518215	8936
4043A_4	11	37527477	37527477	GC	37518215	9262
4043A_4	12	648079	648079	CT	647696	383
4043A_4	12	17058657	17058657	GC	17059300	643
4043A_4	12	27910895	27910895	AC	27907124	3771
4043A_4	12	28335830	28335830	CT	28335770	60
4043A_4	12	72181254	72181254	GC	72182023	769
4043A_4	12	84879715	84879715	CG	84870817	8898
4043A_4	16	23669108	23669108	CT	23664873	4235
4043A_4	16	23672710	23672710	CT	23664873	7837
4043A_4	16	23674640	23674640	CT	23664873	9767
4043A_4	16	31356781	31356781	TC	31357940	1159
4043A_4	16	31359368	31359368	AC	31357940	1428
4043A_4	16	31359369	31359369	AC	31357940	1429
4043A_4	16	86167263	86167263	GA	86171530	4267
4043A_4	17	27314719	27314719	CT	27314164	555
4043A_4	17	38412389	38412389	AG	38412225	164
4043A_4	18	21069329	21069329	TA	21068381	948
4043A_4	18	52452751	52452751	CT	52448544	4207
4043A_4	18	52452751	52452751	CT	52448579	4172
4043A_4	18	57653422	57653422	GA	57652630	792
4043A_4	18	57654535	57654535	GA	57652630	1905
4043A_4	18	57655597	57655597	GC	57652630	2967
4043A_4	18	57656021	57656021	GA	57652630	3391
4043A_4	18	57658143	57658143	GA	57652630	5513
4043A_4	18	57658766	57658766	GT	57652630	6136
4043A_4	18	57660408	57660408	GA	57652630	7778
4043A_4	18	57661518	57661518	GC	57652630	8888
4043A_4	18	57661773	57661773	GT	57652630	9143
4043A_4	18	62000351	62000351	CT	61999851	500
4043A_4	18	62004567	62004567	CT	61999851	4716
4043A_4	18	62004758	62004758	CT	61999851	4907
4043A_4	18	62005326	62005326	CA	61999851	5475
4043A_4	18	62007482	62007482	CT	61999851	7631
4043A_4	18	62008436	62008436	CT	61999851	8585
4043A_4	18	62008924	62008924	CT	61999851	9073
4043A_4	18	68062167	68062167	CT	68060061	2106
4043A_4	18	68062912	68062912	CT	68060061	2851
4043A_4	18	68066580	68066580	CG	68060061	6519
4043A_4	18	68066872	68066872	CG	68060061	6811
4043A_4	18	68068680	68068680	CT	68060061	8619
4043A_4	18	68069083	68069083	CT	68060061	9022
4043A_4	18	68155238	68155238	GT	68164027	8789
4043A_4	18	68158478	68158478	GA	68164027	5549
4043A_4	18	68159718	68159718	GA	68164027	4309
4043A_4	18	68160235	68160235	GC	68164027	3792
4043A_4	18	68161648	68161648	GA	68164027	2379
4043A_4	18	68162823	68162823	GA	68164027	1204
4043A_4	X	73535722	73535722	AC	73530037	5685
4043A_4	X	80677492	80677492	GA	80677164	328
4043A_4	X	80678760	80678760	GT	80677164	1596
4043A_4	X	80679204	80679204	GA	80677164	2040
4043A_4	X	90544560	90544560	GT	90535902	8658
4043A_4	3	12622118	12622118	CT	12625599	3481
4043A_4	3	12624400	12624400	CT	12625599	1199
4043A_4	3	12624727	12624727	CT	12625599	872
4043A_4	3	14776487	14776487	CA	14775260	1227
4043A_4	3	14776487	14776487	CA	14775931	556
4043A_4	3	14776487	14776487	CA	14775943	544
4043A_4	3	31138281	31138281	GA	31132863	5418
4043A_4	3	31138560	31138560	GA	31132863	5697
4043A_4	3	59696017	59696017	GA	59691933	4084
4043A_4	3	59696019	59696019	GA	59691933	4086
4043A_4	3	66693037	66693037	TG	66697806	4769
4043A_4	3	173702891	173702891	CT	173702887	4
4043A_4	3	173991669	173991669	AT	174000913	9244
4043A_4	3	186786497	186786497	GA	186788422	1925
4043A_4	3	186786821	186786821	GA	186788422	1601
4043A_4	3	186788672	186788672	GA	186788422	250
4043A_4	3	186789280	186789280	GA	186788422	858
4043A_4	3	186789722	186789722	GC	186788422	1300
4043A_4	3	186789990	186789990	GA	186788422	1568
4043A_4	3	186790094	186790094	GA	186788422	1672
4043A_4	3	186790686	186790686	GA	186788422	2264
4043A_4	3	186790948	186790948	GA	186788422	2526
4043A_4	3	186791254	186791254	GA	186788422	2832
4043A_4	3	186786497	186786497	GA	186794200	7703
4043A_4	3	186786821	186786821	GA	186794200	7379
4043A_4	3	186788672	186788672	GA	186794200	5528
4043A_4	3	186789280	186789280	GA	186794200	4920
4043A_4	3	186789722	186789722	GC	186794200	4478
4043A_4	3	186789990	186789990	GA	186794200	4210
4043A_4	3	186790094	186790094	GA	186794200	4106
4043A_4	3	186790686	186790686	GA	186794200	3514
4043A_4	3	186790948	186790948	GA	186794200	3252
4043A_4	3	186791254	186791254	GA	186794200	2946
4043A_4	4	57730607	57730607	GA	57730456	151
4043A_4	5	272500	272500	GT	272220	280
4043A_4	6	122050781	122050781	TC	122044097	6684
4043A_4	6	122105027	122105027	CG	122097906	7121
4043A_4	8	3821311	3821311	GA	3813335	7976
4043A_4	8	3821745	3821745	GA	3813335	8410
4043A_4	8	3823313	3823313	GA	3813335	9978
4043A_4	8	3821311	3821311	GA	3820857	454
4043A_4	8	3821745	3821745	GA	3820857	888
4043A_4	8	3823313	3823313	GA	3820857	2456
4043A_4	10	46069896	46069896	GA	46073797	3901
4043A_4	10	46070582	46070582	GA	46073797	3215
4043A_4	10	46071212	46071212	GA	46073797	2585
4043A_4	10	46071373	46071373	GC	46073797	2424
4043A_4	10	46071548	46071548	GC	46073797	2249
4043A_4	10	46072529	46072529	GA	46073797	1268
4043A_4	10	46073364	46073364	GA	46073797	433
4043A_4	12	242246	242246	AG	249989	7743
4043A_4	12	18353952	18353952	AC	18357267	3315
4043A_4	12	27910895	27910895	AC	27907277	3618
4043A_4	12	27910895	27910895	AC	27909291	1604
4043A_4	12	55685330	55685330	CA	55685881	551
4043A_4	12	55685698	55685698	CT	55685881	183
4043A_4	12	59473153	59473153	GT	59469843	3310
4043A_4	12	63186577	63186577	CA	63195549	8972
4043A_4	12	63187962	63187962	CT	63195549	7587
4043A_4	12	63190416	63190416	CT	63195549	5133
4043A_4	12	85619705	85619705	CA	85616775	2930
4043A_4	12	91804816	91804816	GC	91804100	716
4043A_4	12	91807083	91807083	GA	91804100	2983
4043A_4	12	91807424	91807424	GT	91804100	3324
4043A_4	12	91808125	91808125	GC	91804100	4025
4043A_4	12	110147124	110147124	GC	110143613	3511
4043A_4	12	118016361	118016361	CG	118016440	79
4043A_4	12	118023174	118023174	CT	118016440	6734
4043A_4	12	118025449	118025449	CT	118016440	9009
4043A_4	12	122729315	122729315	CT	122731285	1970
4043A_4	12	122733177	122733177	CT	122731285	1892
4043A_4	15	73118878	73118878	AG	73115727	3151
4043A_4	16	21739249	21739249	CT	21737205	2044
4043A_4	18	41332362	41332362	CG	41336176	3814
4043A_4	18	41335386	41335386	CG	41336176	790
4043A_4	18	41335907	41335907	CT	41336176	269
4043A_4	18	52452751	52452751	CT	52448747	4004
4043A_4	18	52452751	52452751	CT	52449425	3326
4043A_4	18	52452751	52452751	CT	52449474	3277
4043A_4	18	52452751	52452751	CT	52449564	3187
4043A_4	18	52452751	52452751	CT	52450433	2318
4043A_4	18	52452751	52452751	CT	52450467	2284
4043A_4	18	52452751	52452751	CT	52451447	1304
4043A_4	18	52452751	52452751	CT	52453540	789
4043A_4	18	52452751	52452751	CT	52459684	6933
4043A_4	18	52452751	52452751	CT	52459758	7007
4043A_4	18	52452751	52452751	CT	52460183	7432
4043A_4	18	55146302	55146302	GT	55142650	3652
4043A_4	18	55146302	55146302	GT	55142849	3453
4043A_4	18	55146302	55146302	GT	55143016	3286
4043A_4	18	55146302	55146302	GT	55145525	777
4043A_4	18	55146302	55146302	GT	55146936	634
4043A_4	18	57653422	57653422	GA	57652629	793
4043A_4	18	57654535	57654535	GA	57652629	1906
4043A_4	18	57655597	57655597	GC	57652629	2968
4043A_4	18	57656021	57656021	GA	57652629	3392
4043A_4	18	57658143	57658143	GA	57652629	5514
4043A_4	18	57658766	57658766	GT	57652629	6137
4043A_4	18	57660408	57660408	GA	57652629	7779
4043A_4	18	57661518	57661518	GC	57652629	8889
4043A_4	18	57661773	57661773	GT	57652629	9144
4043A_4	18	57653422	57653422	GA	57659721	6299
4043A_4	18	57654535	57654535	GA	57659721	5186
4043A_4	18	57655597	57655597	GC	57659721	4124
4043A_4	18	57656021	57656021	GA	57659721	3700
4043A_4	18	57658143	57658143	GA	57659721	1578
4043A_4	18	57658766	57658766	GT	57659721	955
4043A_4	18	57660408	57660408	GA	57659721	687
4043A_4	18	57661518	57661518	GC	57659721	1797
4043A_4	18	57661773	57661773	GT	57659721	2052
4043A_4	18	57663519	57663519	GT	57659721	3798
4043A_4	18	57665244	57665244	GA	57659721	5523
4043A_4	18	57666060	57666060	CT	57659721	6339
4043A_4	18	57666061	57666061	AG	57659721	6340
4043A_4	18	57666491	57666491	GC	57659721	6770
4043A_4	18	58736918	58736918	AG	58728806	8112
4043A_4	18	59838440	59838440	GA	59840500	2060
4043A_4	18	59839986	59839986	GC	59840500	514
4043A_4	18	59840899	59840899	GA	59840500	399
4043A_4	18	59838440	59838440	GA	59841323	2883
4043A_4	18	59839986	59839986	GC	59841323	1337
4043A_4	18	59840899	59840899	GA	59841323	424
4043A_4	18	62000351	62000351	CT	61999852	499
4043A_4	18	62004567	62004567	CT	61999852	4715
4043A_4	18	62004758	62004758	CT	61999852	4906
4043A_4	18	62005326	62005326	CA	61999852	5474
4043A_4	18	62007482	62007482	CT	61999852	7630
4043A_4	18	62008436	62008436	CT	61999852	8584
4043A_4	18	62008924	62008924	CT	61999852	9072
4043A_4	18	68062167	68062167	CT	68052359	9808
4043A_4	18	68155238	68155238	GT	68160861	5623
4043A_4	18	68158478	68158478	GA	68160861	2383
4043A_4	18	68159718	68159718	GA	68160861	1143
4043A_4	18	68160235	68160235	GC	68160861	626
4043A_4	18	68161648	68161648	GA	68160861	787
4043A_4	18	68162823	68162823	GA	68160861	1962
4043A_4	19	3644140	3644140	CT	3644441	301
4043A_4	20	45559948	45559948	CT	45561125	1177
4043A_4	20	45560236	45560236	CT	45561125	889
4043A_4	21	23580983	23580983	CT	23579784	1199
4043A_4	X	34706062	34706062	GA	34707122	1060
4043A_4	X	34707035	34707035	GA	34707122	87
4043A_4	X	34716796	34716796	TA	34707122	9674
4043A_4	X	65955745	65955745	GC	65955470	275
4043A_4	X	73535722	73535722	AC	73527684	8038
4043A_4	X	73912331	73912331	GA	73912647	316
4043A_4	X	73913331	73913331	GA	73912647	684
4043A_4	X	73916030	73916030	AG	73912647	3383
4043A_4	X	73916235	73916235	TA	73912647	3588
4043A_4	X	77103896	77103896	CT	77112708	8812
4043A_4	X	77922258	77922258	GT	77922255	3
4043A_4	X	78342718	78342718	GA	78342715	3
4043A_4	X	78343358	78343358	GC	78342715	643
4043A_4	X	81759777	81759777	GT	81759235	542
4043A_4	X	131101093	131101093	CT	131102152	1059
4043A_4	1	91273806	91273806	TC	91267573	6233
4043A_4	6	65178216	65178216	CT	65178026	190
4043A_4	3	87417900	87417900	CT	87414344	3556
4043A_4	8	3821311	3821311	GA	3821241	70
4043A_4	8	3821745	3821745	GA	3821241	504
4043A_4	8	3823313	3823313	GA	3821241	2072
4043A_4	8	3485160	3485160	GC	3483227	1933
4043A_4	8	3485255	3485255	GA	3483227	2028
4043A_4	8	3485644	3485644	GC	3483227	2417
4043A_4	8	3486127	3486127	GT	3483227	2900
4043A_4	8	3487797	3487797	GA	3483227	4570
4043A_4	8	3487936	3487936	GC	3483227	4709
4043A_4	8	3488293	3488293	GT	3483227	5066
4043A_4	8	3490845	3490845	GA	3483227	7618
4043A_4	8	3821311	3821311	GA	3821605	294
4043A_4	8	3821745	3821745	GA	3821605	140
4043A_4	8	3823313	3823313	GA	3821605	1708
4043A_4	3	186786497	186786497	GA	186793762	7265
4043A_4	3	186786821	186786821	GA	186793762	6941
4043A_4	3	186788672	186788672	GA	186793762	5090
4043A_4	3	186789280	186789280	GA	186793762	4482
4043A_4	3	186789722	186789722	GC	186793762	4040
4043A_4	3	186789990	186789990	GA	186793762	3772
4043A_4	3	186790094	186790094	GA	186793762	3668
4043A_4	3	186790686	186790686	GA	186793762	3076
4043A_4	3	186790948	186790948	GA	186793762	2814
4043A_4	3	186791254	186791254	GA	186793762	2508
4043A_4	7	62510168	62510168	CA	62510471	303
4043A_4	7	62510573	62510573	GC	62510471	102
4043A_4	8	3485160	3485160	GC	3492980	7820
4043A_4	8	3485255	3485255	GA	3492980	7725
4043A_4	8	3485644	3485644	GC	3492980	7336
4043A_4	8	3486127	3486127	GT	3492980	6853
4043A_4	8	3487797	3487797	GA	3492980	5183
4043A_4	8	3487936	3487936	GC	3492980	5044
4043A_4	8	3488293	3488293	GT	3492980	4687
4043A_4	8	3490845	3490845	GA	3492980	2135
4043A_4	8	3645536	3645536	AG	3644158	1378
4043A_4	8	3596387	3596387	AT	3595996	391
4043A_4	3	186786497	186786497	GA	186793810	7313
4043A_4	3	186786821	186786821	GA	186793810	6989
4043A_4	3	186788672	186788672	GA	186793810	5138
4043A_4	3	186789280	186789280	GA	186793810	4530
4043A_4	3	186789722	186789722	GC	186793810	4088
4043A_4	3	186789990	186789990	GA	186793810	3820
4043A_4	3	186790094	186790094	GA	186793810	3716
4043A_4	3	186790686	186790686	GA	186793810	3124
4043A_4	3	186790948	186790948	GA	186793810	2862
4043A_4	3	186791254	186791254	GA	186793810	2556
4043A_4	11	40569586	40569586	CG	40569794	208
4043A_4	12	27910895	27910895	AC	27907370	3525
4043A_4	12	27910895	27910895	AC	27909321	1574
4043A_4	11	2918842	2918842	CT	2909013	9829
4043A_4	12	83561498	83561498	CT	83561745	247
4043A_4	12	100370880	100370880	CT	100379103	8223
4043A_4	12	100371268	100371268	CT	100379103	7835
4043A_4	12	100374036	100374036	CA	100379103	5067
4043A_4	12	118016361	118016361	CG	118015681	680
4043A_4	12	118023174	118023174	CT	118015681	7493
4043A_4	12	118025449	118025449	CT	118015681	9768
4043A_4	11	2918842	2918842	CT	2913545	5297
4043A_4	12	122729315	122729315	CT	122729426	111
4043A_4	12	122733177	122733177	CT	122729426	3751
4043A_4	5	115438747	115438747	TA	115441337	2590
4043A_4	3	173991669	173991669	AT	174001075	9406
4043A_4	3	31138281	31138281	GA	31133177	5104
4043A_4	3	31138560	31138560	GA	31133177	5383
4043A_4	3	31138281	31138281	GA	31133712	4569
4043A_4	3	31138560	31138560	GA	31133712	4848
4043A_4	16	6814352	6814352	AG	6823946	9594
4043A_4	3	31138281	31138281	GA	31133227	5054
4043A_4	3	31138560	31138560	GA	31133227	5333
4043A_4	16	7320484	7320484	GA	7324662	4178
4043A_4	16	7329738	7329738	GA	7324662	5076
4043A_4	16	7330705	7330705	GT	7324662	6043
4043A_4	16	7331138	7331138	GA	7324662	6476
4043A_4	16	7331338	7331338	GC	7324662	6676
4043A_4	16	7332660	7332660	GT	7324662	7998
4043A_4	16	7333010	7333010	GA	7324662	8348
4043A_4	16	7334368	7334368	GT	7324662	9706
4043A_4	16	7329738	7329738	GA	7337436	7698
4043A_4	16	7330705	7330705	GT	7337436	6731
4043A_4	16	7331138	7331138	GA	7337436	6298
4043A_4	16	7331338	7331338	GC	7337436	6098
4043A_4	16	7332660	7332660	GT	7337436	4776
4043A_4	16	7333010	7333010	GA	7337436	4426
4043A_4	16	7334368	7334368	GT	7337436	3068
4043A_4	16	7335484	7335484	GA	7337436	1952
4043A_4	16	7336608	7336608	GA	7337436	828
4043A_4	16	7344637	7344637	GA	7337436	7201
4043A_4	16	7329738	7329738	GA	7338194	8456
4043A_4	16	7330705	7330705	GT	7338194	7489
4043A_4	16	7331138	7331138	GA	7338194	7056
4043A_4	16	7331338	7331338	GC	7338194	6856
4043A_4	16	7332660	7332660	GT	7338194	5534
4043A_4	16	7333010	7333010	GA	7338194	5184
4043A_4	16	7334368	7334368	GT	7338194	3826
4043A_4	16	7335484	7335484	GA	7338194	2710
4043A_4	16	7336608	7336608	GA	7338194	1586
4043A_4	16	7344637	7344637	GA	7338194	6443
4043A_4	11	45977323	45977323	GA	45977010	313
4043A_4	11	45977519	45977519	GA	45977010	509
4043A_4	11	45977606	45977606	GC	45977010	596
4043A_4	16	8494280	8494280	GC	8492151	2129
4043A_4	16	8494712	8494712	GC	8492151	2561
4043A_4	16	8495027	8495027	GT	8492151	2876
4043A_4	16	8495241	8495241	GA	8492151	3090
4043A_4	16	8495817	8495817	GA	8492151	3666
4043A_4	14	105316575	105316575	GA	105317065	490
4043A_4	16	8566026	8566026	GT	8574372	8346
4043A_4	11	103518981	103518981	CT	103519165	184
4043A_4	16	16011808	16011808	CG	16013466	1658
4043A_4	11	56331515	56331515	CT	56329669	1846
4043A_4	11	56332518	56332518	CT	56329669	2849
4043A_4	11	56332730	56332730	CT	56329669	3061
4043A_4	11	56332826	56332826	CA	56329669	3157
4043A_4	11	56333502	56333502	CG	56329669	3833
4043A_4	11	56334599	56334599	CT	56329669	4930
4043A_4	11	56337172	56337172	CT	56329669	7503
4043A_4	11	56337437	56337437	CT	56329669	7768
4043A_4	11	56337654	56337654	CT	56329669	7985
4043A_4	11	55009333	55009333	AT	55007485	1848
4043A_4	12	123011480	123011480	GC	123019537	8057
4043A_4	12	123013869	123013869	GA	123019537	5668
4043A_4	12	123014246	123014246	GA	123019537	5291
4043A_4	12	123014715	123014715	GC	123019537	4822
4043A_4	12	123017396	123017396	GT	123019537	2141
4043A_4	12	123017624	123017624	GA	123019537	1913
4043A_4	3	175387699	175387699	CG	175389039	1340
4043A_4	3	175389014	175389014	CT	175389039	25
4043A_4	18	41133579	41133579	CG	41135287	1708
4043A_4	3	177407646	177407646	GA	177411373	3727
4043A_4	3	177408264	177408264	GA	177411373	3109
4043A_4	3	177409937	177409937	GA	177411373	1436
4043A_4	18	41332362	41332362	CG	41330866	1496
4043A_4	18	41335386	41335386	CG	41330866	4520
4043A_4	18	41335907	41335907	CT	41330866	5041
4043A_4	3	177407646	177407646	GA	177411297	3651
4043A_4	3	177408264	177408264	GA	177411297	3033
4043A_4	3	177409937	177409937	GA	177411297	1360
4043A_4	18	41332362	41332362	CG	41337786	5424
4043A_4	18	41335386	41335386	CG	41337786	2400
4043A_4	18	41335907	41335907	CT	41337786	1879
4043A_4	18	45599555	45599555	CG	45600595	1040
4043A_4	18	45599775	45599775	CT	45600595	820
4043A_4	18	45600112	45600112	CA	45600595	483
4043A_4	18	52452751	52452751	CT	52448565	4186
4043A_4	18	52452751	52452751	CT	52448724	4027
4043A_4	12	27910895	27910895	AC	27903289	7606
4043A_4	18	52452751	52452751	CT	52448731	4020
4043A_4	12	27910895	27910895	AC	27910889	6
4043A_4	18	52452751	52452751	CT	52449378	3373
4043A_4	18	52452751	52452751	CT	52452598	153
4043A_4	18	52452751	52452751	CT	52452627	124
4043A_4	18	52452751	52452751	CT	52453735	984
4043A_4	18	52452751	52452751	CT	52458500	5749
4043A_4	18	52452751	52452751	CT	52459054	6303
4043A_4	12	27910895	27910895	AC	27913305	2410
4043A_4	18	52452751	52452751	CT	52459672	6921
4043A_4	18	52452751	52452751	CT	52459684	6933
4043A_4	18	52452751	52452751	CT	52460057	7306
4043A_4	12	27910895	27910895	AC	27907298	3597
4043A_4	3	173702891	173702891	CT	173703142	251
4043A_4	18	55146302	55146302	GT	55143335	2967
4043A_4	3	173702891	173702891	CT	173702554	337
4043A_4	18	55146302	55146302	GT	55143756	2546
4043A_4	18	55146302	55146302	GT	55148225	1923
4043A_4	3	173702891	173702891	CT	173703053	162
4043A_4	18	57658143	57658143	GA	57667334	9191
4043A_4	18	57658766	57658766	GT	57667334	8568
4043A_4	18	57660408	57660408	GA	57667334	6926
4043A_4	18	57661518	57661518	GC	57667334	5816
4043A_4	18	57661773	57661773	GT	57667334	5561
4043A_4	18	57663519	57663519	GT	57667334	3815
4043A_4	18	57665244	57665244	GA	57667334	2090
4043A_4	18	57666060	57666060	CT	57667334	1274
4043A_4	18	57666061	57666061	AG	57667334	1273
4043A_4	18	57666491	57666491	GC	57667334	843
4043A_4	3	173702891	173702891	CT	173703087	196
4043A_4	3	181549934	181549934	TA	181549971	37
4043A_4	12	27910895	27910895	AC	27910877	18
4043A_4	12	27910895	27910895	AC	27909172	1723
4043A_4	18	68062167	68062167	CT	68052315	9852
4043A_4	12	27910895	27910895	AC	27907136	3759
4043A_4	18	68062167	68062167	CT	68054815	7352
4043A_4	18	68062912	68062912	CT	68054815	8097
4043A_4	12	27910895	27910895	AC	27910818	77
4043A_4	18	68062167	68062167	CT	68054905	7262
4043A_4	18	68062912	68062912	CT	68054905	8007
4043A_4	12	27910895	27910895	AC	27909172	1723
4043A_4	18	68068680	68068680	CT	68078336	9656
4043A_4	18	68069083	68069083	CT	68078336	9253
4043A_4	18	68070255	68070255	CG	68078336	8081
4043A_4	18	68070485	68070485	CT	68078336	7851
4043A_4	18	68075093	68075093	AC	68078336	3243
4043A_4	18	68386602	68386602	GT	68392703	6101
4043A_4	18	68386602	68386602	GT	68392705	6103
4043A_4	18	68386602	68386602	GT	68392745	6143
4043A_4	18	68403833	68403833	GT	68403464	369
4043A_4	18	69394630	69394630	GT	69394335	295
4043A_4	18	69461444	69461444	CT	69461191	253
4043A_4	18	69464731	69464731	CA	69461191	3540
4043A_4	18	69465330	69465330	CG	69461191	4139
4043A_4	18	69465713	69465713	CA	69461191	4522
4043A_4	18	69466264	69466264	CT	69461191	5073
4043A_4	18	69466359	69466359	CT	69461191	5168
4043A_4	18	69470059	69470059	CG	69461191	8868
4043A_4	18	69470255	69470255	CT	69461191	9064
4043A_4	18	73206507	73206507	CG	73214296	7789
4043A_4	18	73206924	73206924	CT	73214296	7372
4043A_4	18	73206925	73206925	CG	73214296	7371
4043A_4	18	77690728	77690728	GA	77690044	684
4043A_4	18	77691012	77691012	GA	77690044	968
4043A_4	18	77691764	77691764	GT	77690044	1720
4043A_4	18	77690728	77690728	GA	77690283	445
4043A_4	18	77691012	77691012	GA	77690283	729
4043A_4	18	77691764	77691764	GT	77690283	1481
4043A_4	19	3217420	3217420	GA	3215722	1698
4043A_4	19	3217764	3217764	GA	3215722	2042
4043A_4	19	3218259	3218259	GA	3215722	2537
4043A_4	18	69133279	69133279	CG	69133350	71
4043A_4	1	142656625	142656625	AC	142648143	8482
4043A_4	19	29660380	29660380	GA	29661197	817
4043A_4	3	65149295	65149295	CA	65151100	1805
4043A_4	19	30317342	30317342	AT	30321692	4350
4043A_4	19	30330019	30330019	CA	30321692	8327
4043A_4	19	30330107	30330107	CT	30321692	8415
4043A_4	19	30330565	30330565	CT	30321692	8873
4043A_4	19	30330697	30330697	CT	30321692	9005
4043A_4	19	30351938	30351938	TC	30349282	2656
4043A_4	11	37524112	37524112	CT	37527839	3727
4043A_4	11	37525970	37525970	CT	37527839	1869
4043A_4	11	37527151	37527151	GA	37527839	688
4043A_4	11	37527477	37527477	GC	37527839	362
4043A_4	8	40539821	40539821	CT	40540140	319
4043A_4	11	55586265	55586265	GC	55585515	750
4043A_4	11	60538525	60538525	CA	60537662	863
4043A_4	11	60538877	60538877	CG	60537662	1215
4043A_4	11	60539819	60539819	CT	60537662	2157
4043A_4	6	66533378	66533378	CT	66537978	4600
4043A_4	18	68454939	68454939	TG	68461078	6139
4043A_4	20	4623253	4623253	CT	4625392	2139
4043A_4	20	4626052	4626052	CA	4625392	660
4043A_4	20	4987473	4987473	CT	4988900	1427
4043A_4	20	4993501	4993501	CT	4988900	4601
4043A_4	20	4993720	4993720	CT	4988900	4820
4043A_4	3	124041429	124041429	CT	124042743	1314
4043A_4	3	175060969	175060969	GT	175060641	328
4043A_4	20	11338047	11338047	AG	11329680	8367
4043A_4	20	13449614	13449614	GA	13444540	5074
4043A_4	20	13450034	13450034	GA	13444540	5494
4043A_4	20	13450212	13450212	GC	13444540	5672
4043A_4	20	20294390	20294390	TG	20302253	7863
4043A_4	18	21069329	21069329	TA	21078658	9329
4043A_4	20	37034405	37034405	GC	37033627	778
4043A_4	18	68386602	68386602	GT	68392655	6053
4043A_4	4	58761935	58761935	TG	58758832	3103
4043A_4	4	57730607	57730607	GA	57734383	3776
4043A_4	20	49436789	49436789	GC	49428310	8479
4043A_4	16	7267491	7267491	CT	7262411	5080
4043A_4	16	7270322	7270322	CA	7262411	7911
4043A_4	X	28634645	28634645	GA	28635117	472
4043A_4	X	28634936	28634936	GA	28635117	181
4043A_4	11	30036581	30036581	AG	30027148	9433
4043A_4	X	28634645	28634645	GA	28637306	2661
4043A_4	X	28634936	28634936	GA	28637306	2370
4043A_4	X	34442126	34442126	CA	34441952	174
4043A_4	X	34445093	34445093	GA	34441952	3141
4043A_4	X	34446713	34446713	GA	34441952	4761
4043A_4	6	65178216	65178216	CT	65178469	253
4043A_4	X	34446713	34446713	GA	34455118	8405
4043A_4	X	34453999	34453999	TC	34455118	1119
4043A_4	6	65178216	65178216	CT	65178153	63
4043A_4	18	34967900	34967900	CT	34973041	5141
4043A_4	18	34969272	34969272	CT	34973041	3769
4043A_4	18	34969869	34969869	TA	34973041	3172
4043A_4	18	34970532	34970532	CT	34973041	2509
4043A_4	18	34971010	34971010	CT	34973041	2031
4043A_4	18	34971220	34971220	CT	34973041	1821
4043A_4	18	34971441	34971441	CA	34973041	1600
4043A_4	18	34972533	34972533	CA	34973041	508
4043A_4	19	53812436	53812436	GA	53819890	7454
4043A_4	X	65350983	65350983	CT	65351149	166
4043A_4	18	24382138	24382138	TG	24380963	1175
4043A_4	X	66105235	66105235	GA	66108597	3362
4043A_4	X	66107359	66107359	GC	66108597	1238
4043A_4	X	66107553	66107553	GA	66108597	1044
4043A_4	11	30352936	30352936	CT	30353818	882
4043A_4	11	30353774	30353774	CT	30353818	44
4043A_4	12	648079	648079	CT	648256	177
4043A_4	19	42966593	42966593	CT	42965689	904
4043A_4	19	42967100	42967100	CT	42965689	1411
4043A_4	6	65178216	65178216	CT	65178331	115
4043A_4	X	69355858	69355858	GC	69357846	1988
4043A_4	X	69356065	69356065	GT	69357846	1781
4043A_4	6	65178216	65178216	CT	65178469	253
4043A_4	20	4623253	4623253	CT	4625716	2463
4043A_4	20	4626052	4626052	CA	4625716	336
4043A_4	X	73122806	73122806	CT	73128014	5208
4043A_4	X	73897576	73897576	GC	73901416	3840
4043A_4	20	12867945	12867945	CG	12865436	2509
4043A_4	X	73912331	73912331	GA	73912724	393
4043A_4	X	73913331	73913331	GA	73912724	607
4043A_4	X	73916030	73916030	AG	73912724	3306
4043A_4	X	73916235	73916235	TA	73912724	3511
4043A_4	18	68403833	68403833	GT	68404675	842
4043A_4	X	74330237	74330237	CG	74332219	1982
4043A_4	X	74331837	74331837	CT	74332219	382
4043A_4	3	124041429	124041429	CT	124040779	650
4043A_4	6	65178216	65178216	CT	65177995	221
4043A_4	16	21739249	21739249	CT	21736816	2433
4043A_4	X	75500493	75500493	GA	75497378	3115
4043A_4	X	75502189	75502189	GC	75497378	4811
4043A_4	X	75505689	75505689	TG	75497378	8311
4043A_4	X	75500493	75500493	GA	75498212	2281
4043A_4	X	75502189	75502189	GC	75498212	3977
4043A_4	X	75505689	75505689	TG	75498212	7477
4043A_4	X	75500493	75500493	GA	75508338	7845
4043A_4	X	75502189	75502189	GC	75508338	6149
4043A_4	X	75505689	75505689	TG	75508338	2649
4043A_4	X	75500493	75500493	GA	75508591	8098
4043A_4	X	75502189	75502189	GC	75508591	6402
4043A_4	X	75505689	75505689	TG	75508591	2902
4043A_4	12	242246	242246	AG	242485	239
4043A_4	X	77142540	77142540	TG	77147249	4709
4043A_4	X	77643349	77643349	CT	77648578	5229
4043A_4	X	77643822	77643822	CT	77648578	4756
4043A_4	X	77643963	77643963	CT	77648578	4615
4043A_4	X	77684185	77684185	GC	77684095	90
4043A_4	11	55586265	55586265	GC	55586981	716
4043A_4	3	66999263	66999263	CT	66999192	71
4043A_4	6	66505017	66505017	CT	66512652	7635
4043A_4	16	8494280	8494280	GC	8493456	824
4043A_4	16	8494712	8494712	GC	8493456	1256
4043A_4	16	8495027	8495027	GT	8493456	1571
4043A_4	16	8495241	8495241	GA	8493456	1785
4043A_4	16	8495817	8495817	GA	8493456	2361
4043A_4	20	16552259	16552259	TC	16552259	0
4043A_4	X	78773622	78773622	GA	78772854	768
4043A_4	3	87417900	87417900	CT	87413317	4583
4043A_4	X	78773622	78773622	GA	78777355	3733
4043A_4	6	65178216	65178216	CT	65178147	69
4043A_4	11	55586265	55586265	GC	55582820	3445
4043A_4	X	79544946	79544946	CG	79547983	3037
4043A_4	8	3485160	3485160	GC	3490815	5655
4043A_4	8	3485255	3485255	GA	3490815	5560
4043A_4	8	3485644	3485644	GC	3490815	5171
4043A_4	8	3486127	3486127	GT	3490815	4688
4043A_4	8	3487797	3487797	GA	3490815	3018
4043A_4	8	3487936	3487936	GC	3490815	2879
4043A_4	8	3488293	3488293	GT	3490815	2522
4043A_4	8	3490845	3490845	GA	3490815	30
4043A_4	6	65178216	65178216	CT	65177929	287
4043A_4	X	81107886	81107886	CG	81115249	7363
4043A_4	X	81211431	81211431	CT	81208314	3117
4043A_4	X	81212195	81212195	CT	81208314	3881
4043A_4	X	81287039	81287039	GA	81287598	559
4043A_4	X	81759777	81759777	GT	81760929	1152
4043A_4	14	106053021	106053021	GT	106051605	1416
4043A_4	14	106054237	106054237	GA	106051605	2632
4043A_4	14	106054541	106054541	GA	106051605	2936
4043A_4	14	106055160	106055160	GA	106051605	3555
4043A_4	14	106057741	106057741	GC	106051605	6136
4043A_4	11	56331515	56331515	CT	56337919	6404
4043A_4	11	56332518	56332518	CT	56337919	5401
4043A_4	11	56332730	56332730	CT	56337919	5189
4043A_4	11	56332826	56332826	CA	56337919	5093
4043A_4	11	56333502	56333502	CG	56337919	4417
4043A_4	11	56334599	56334599	CT	56337919	3320
4043A_4	11	56337172	56337172	CT	56337919	747
4043A_4	11	56337437	56337437	CT	56337919	482
4043A_4	11	56337654	56337654	CT	56337919	265
4043A_4	11	56343066	56343066	TA	56337919	5147
4043A_4	X	85253318	85253318	CT	85251753	1565
4043A_4	11	56331515	56331515	CT	56334977	3462
4043A_4	11	56332518	56332518	CT	56334977	2459
4043A_4	11	56332730	56332730	CT	56334977	2247
4043A_4	11	56332826	56332826	CA	56334977	2151
4043A_4	11	56333502	56333502	CG	56334977	1475
4043A_4	11	56334599	56334599	CT	56334977	378
4043A_4	11	56337172	56337172	CT	56334977	2195
4043A_4	11	56337437	56337437	CT	56334977	2460
4043A_4	11	56337654	56337654	CT	56334977	2677
4043A_4	11	56343066	56343066	TA	56334977	8089
4043A_4	3	85137600	85137600	GA	85137963	363
4043A_4	X	86306442	86306442	GA	86313487	7045
4043A_4	X	86309301	86309301	GA	86313487	4186
4043A_4	X	86311614	86311614	GA	86313487	1873
4043A_4	X	86312564	86312564	GA	86313487	923
4043A_4	X	86313377	86313377	GT	86313487	110
4043A_4	X	86313525	86313525	GC	86313487	38
4043A_4	16	21739249	21739249	CT	21736775	2474
4043A_4	X	86306442	86306442	GA	86313491	7049
4043A_4	X	86309301	86309301	GA	86313491	4190
4043A_4	X	86311614	86311614	GA	86313491	1877
4043A_4	X	86312564	86312564	GA	86313491	927
4043A_4	X	86313377	86313377	GT	86313491	114
4043A_4	X	86313525	86313525	GC	86313491	34
4043A_4	X	86306442	86306442	GA	86313717	7275
4043A_4	X	86309301	86309301	GA	86313717	4416
4043A_4	X	86311614	86311614	GA	86313717	2103
4043A_4	X	86312564	86312564	GA	86313717	1153
4043A_4	X	86313377	86313377	GT	86313717	340
4043A_4	X	86313525	86313525	GC	86313717	192
4043A_4	X	86339987	86339987	GA	86339991	4
4043A_4	X	86369230	86369230	CT	86363119	6111
4043A_4	X	86369230	86369230	CT	86363148	6082
4043A_4	6	65178216	65178216	CT	65178433	217
4043A_4	6	65178216	65178216	CT	65178434	218
4043A_4	X	88039813	88039813	GA	88035962	3851
4043A_4	X	124285593	124285593	GC	124288910	3317
4043A_4	12	27910895	27910895	AC	27903502	7393
4043A_4	X	150273863	150273863	GA	150273788	75
4043A_4	12	242246	242246	AG	242050	196
4043A_4	X	151704532	151704532	GC	151708515	3983
4043A_4	X	151705598	151705598	GA	151708515	2917
4043A_4	X	151706318	151706318	GA	151708515	2197
4043A_4	19	53812436	53812436	GA	53819629	7193
4043A_4	X	153650289	153650289	CT	153650162	127
4043A_4	X	153652584	153652584	CG	153650162	2422
4043A_4	X	153659659	153659659	CT	153650162	9497
4043A_4	19	53812436	53812436	GA	53812056	380
4043A_4	X	153650289	153650289	CT	153650283	6
4043A_4	X	153652584	153652584	CG	153650283	2301
4043A_4	X	153659659	153659659	CT	153650283	9376
4043A_4	X	153650289	153650289	CT	153650632	343
4043A_4	X	153652584	153652584	CG	153650632	1952
4043A_4	X	153659659	153659659	CT	153650632	9027
4043A_4	X	153660585	153660585	CT	153650632	9953
4043A_4	X	153650289	153650289	CT	153659981	9692
4043A_4	X	153652584	153652584	CG	153659981	7397
4043A_4	X	153659659	153659659	CT	153659981	322
4043A_4	X	153660585	153660585	CT	153659981	604
4043A_4	X	153661014	153661014	CG	153659981	1033
4043A_4	X	153661136	153661136	CT	153659981	1155
4043A_4	X	153661428	153661428	CA	153659981	1447
4043A_4	X	153661650	153661650	CT	153659981	1669
4043A_4	X	153662080	153662080	CT	153659981	2099
4043A_4	X	153662664	153662664	CG	153659981	2683
4043A_4	X	153663071	153663071	CA	153659981	3090
4043A_4	X	153663179	153663179	CG	153659981	3198
4043A_4	X	153663627	153663627	CG	153659981	3646
4043A_4	X	153663824	153663824	CT	153659981	3843
4043A_4	8	7005759	7005759	GC	7005436	323
4043A_4	8	7006070	7006070	GA	7005436	634
4043A_4	8	7006171	7006171	GA	7005436	735
4043A_4	8	7006410	7006410	GA	7005436	974
4043A_4	19	53812436	53812436	GA	53813013	577
4043A_4	X	153901556	153901556	CT	153899478	2078
4043A_4	X	153901557	153901557	CT	153899478	2079
4043A_4	X	153901556	153901556	CT	153900471	1085
4043A_4	X	153901557	153901557	CT	153900471	1086
4043A_4	X	153901556	153901556	CT	153900473	1083
4043A_4	X	153901557	153901557	CT	153900473	1084
4333	3	183601114	183601114	TC	183602512	1398
4333	3	186789303	186789303	TC	186794726	5423
4333	11	100216545	100216545	CA	100221506	4961
4333	11	105007686	105007686	CA	105004756	2930
4333	11	103471493	103471493	GA	103462034	9459
4333	7	115972649	115972649	GT	115963010	9639
4333	7	115972828	115972828	GC	115963010	9818
4333	7	115972649	115972649	GT	115972218	431
4333	7	115972828	115972828	GC	115972218	610
4333	11	100216545	100216545	CA	100221509	4964
4333	11	100959257	100959257	GT	100959087	170
4333	11	102590607	102590607	GA	102591310	703
4333	11	102594264	102594264	GC	102591310	2954
4333	11	103269425	103269425	GC	103273505	4080
4333	11	103270434	103270434	GA	103273505	3071
4333	11	103271151	103271151	GA	103273505	2354
4333	11	103272246	103272246	GA	103273505	1259
4333	3	164208240	164208240	CA	164201250	6990
4333	2	157429838	157429838	CT	157429692	146
4333	2	157429972	157429972	CT	157429692	280
4333	2	157430813	157430813	CT	157429692	1121
4333	2	157431247	157431247	CT	157429692	1555
4333	11	100204688	100204688	CT	100206909	2221
4333	11	100216545	100216545	CA	100206909	9636
4333	11	103203718	103203718	AG	103203999	281
4333	3	186789303	186789303	TC	186793681	4378
4333	11	105049126	105049126	GA	105050205	1079
4333	14	88411382	88411382	CG	88414258	2876
4333	14	88412131	88412131	CG	88414258	2127
4856_1	3	115238513	115238513	GC	115239413	900
4856_1	3	152240920	152240920	CT	152243165	2245
4856_1	3	152242266	152242266	CT	152243165	899
4856_1	3	152242956	152242956	CG	152243165	209
4856_1	3	152245421	152245421	CT	152243165	2256
4856_1	4	91976312	91976312	TC	91983071	6759
4856_1	7	147059732	147059732	CT	147060948	1216
4856_1	20	60390013	60390013	CT	60390425	412
4856_1	3	145228274	145228274	GA	145227208	1066
4856_1	19	17922639	17922639	CG	17924561	1922
4856_1	20	57546980	57546980	GA	57545177	1803
4856_1	20	61506000	61506000	CT	61504060	1940
4856_1	20	61506000	61506000	CT	61505860	140
4856_1	21	18117360	18117360	CT	18110064	7296
4856_1	3	125720864	125720864	CG	125721242	378
4856_1	6	65620306	65620306	GA	65614770	5536
4856_1	6	65620741	65620741	GC	65614770	5971
4856_1	6	65621493	65621493	GA	65614770	6723
4856_1	7	38015684	38015684	CG	38018061	2377
4856_1	7	38016085	38016085	CG	38018061	1976
4856_1	7	38016977	38016977	CA	38018061	1084
4856_1	7	38017604	38017604	CT	38018061	457
4856_1	7	38017732	38017732	CA	38018061	329
4856_1	7	38015684	38015684	CG	38021018	5334
4856_1	7	38016085	38016085	CG	38021018	4933
4856_1	7	38016977	38016977	CA	38021018	4041
4856_1	7	38017604	38017604	CT	38021018	3414
4856_1	7	38017732	38017732	CA	38021018	3286
4856_1	7	50998509	50998509	TC	50992284	6225
4856_1	8	127073863	127073863	TG	127081426	7563
4856_1	19	11502453	11502453	TA	11502669	216
4856_1	19	17922639	17922639	CG	17922842	203
4856_1	20	58584532	58584532	AC	58575451	9081
4856_1	20	60390013	60390013	CT	60388218	1795
4856_1	21	25193190	25193190	CT	25193559	369
4856_1	21	25193391	25193391	CT	25193559	168
4856_1	21	25193499	25193499	CT	25193559	60
4856_1	7	35447276	35447276	AT	35446961	315
4856_1	7	35447421	35447421	AC	35446961	460
4856_1	7	35447700	35447700	AG	35446961	739
4856_1	7	38015684	38015684	CG	38020608	4924
4856_1	7	38016085	38016085	CG	38020608	4523
4856_1	7	38016977	38016977	CA	38020608	3631
4856_1	7	38017604	38017604	CT	38020608	3004
4856_1	7	38017732	38017732	CA	38020608	2876
4856_1	7	56684242	56684242	CG	56684845	603
4856_1	3	85179930	85179930	TG	85180307	377
4856_1	19	17922639	17922639	CG	17925287	2648
4856_1	7	42332760	42332760	CT	42333534	774
4856_1	7	42333137	42333137	CG	42333534	397
4856_1	19	24070006	24070006	GA	24069260	746
4856_1	19	24070201	24070201	GT	24069260	941
4856_1	20	58584532	58584532	AC	58576752	7780
4856_1	5	23109642	23109642	CG	23111578	1936
4856_1	5	23109777	23109777	CT	23111578	1801
4856_1	5	23110119	23110119	CG	23111578	1459
4856_1	5	23110241	23110241	CG	23111578	1337
4856_1	5	23110487	23110487	CG	23111578	1091
4856_1	5	23110713	23110713	CG	23111578	865
4856_1	5	23110999	23110999	CG	23111578	579
4856_1	5	23111422	23111422	CT	23111578	156
4856_1	21	25431644	25431644	GC	25431272	372
4856_1	21	25432098	25432098	GA	25431272	826
4856_1	21	25432303	25432303	GA	25431272	1031
4856_1	21	25433066	25433066	GC	25431272	1794
4856_1	21	25433229	25433229	GC	25431272	1957
4856_3	2	126435776	126435776	CT	126443247	7471
4856_3	3	144687641	144687641	CT	144687885	244
4856_3	3	152242266	152242266	CT	152243165	899
4856_3	3	152242956	152242956	CG	152243165	209
4856_3	3	152245421	152245421	CT	152243165	2256
4856_3	7	147059732	147059732	CT	147060948	1216
4856_3	17	58560407	58560407	AC	58562552	2145
4856_3	20	60390013	60390013	CT	60390425	412
4856_3	21	25193190	25193190	CT	25193560	370
4856_3	21	25193391	25193391	CT	25193560	169
4856_3	21	25193499	25193499	CT	25193560	61
4856_3	3	145228274	145228274	GA	145227208	1066
4856_3	7	55392735	55392735	GC	55392619	116
4856_3	7	55395271	55395271	GA	55392619	2652
4856_3	7	55397704	55397704	GA	55392619	5085
4856_3	7	55397844	55397844	GT	55392619	5225
4856_3	7	55399001	55399001	GA	55392619	6382
4856_3	11	84254685	84254685	AT	84254671	14
4856_3	19	17922639	17922639	CG	17924561	1922
4856_3	20	57546980	57546980	GA	57545177	1803
4856_3	20	61506000	61506000	CT	61504060	1940
4856_3	20	61506000	61506000	CT	61505860	140
4856_3	3	125720864	125720864	CG	125721270	406
4856_3	6	65620306	65620306	GA	65614758	5548
4856_3	6	65620741	65620741	GC	65614758	5983
4856_3	6	65621493	65621493	GA	65614758	6735
4856_3	7	38014820	38014820	CT	38017975	3155
4856_3	7	38015239	38015239	CT	38017975	2736
4856_3	7	38015684	38015684	CG	38017975	2291
4856_3	7	38016085	38016085	CG	38017975	1890
4856_3	7	38016977	38016977	CA	38017975	998
4856_3	7	38017604	38017604	CT	38017975	371
4856_3	7	38017732	38017732	CA	38017975	243
4856_3	7	38018069	38018069	CT	38017975	94
4856_3	19	11502453	11502453	TA	11502668	215
4856_3	19	17922639	17922639	CG	17922842	203
4856_3	19	17922639	17922639	CG	17927533	4894
4856_3	20	58584532	58584532	AC	58575451	9081
4856_3	20	60390013	60390013	CT	60388194	1819
4856_3	21	14341077	14341077	AC	14340297	780
4856_3	21	25193190	25193190	CT	25193559	369
4856_3	21	25193391	25193391	CT	25193559	168
4856_3	21	25193499	25193499	CT	25193559	60
4856_3	7	35447276	35447276	AT	35446960	316
4856_3	7	35447421	35447421	AC	35446960	461
4856_3	7	35447700	35447700	AG	35446960	740
4856_3	7	38014820	38014820	CT	38020608	5788
4856_3	7	38015239	38015239	CT	38020608	5369
4856_3	7	38015684	38015684	CG	38020608	4924
4856_3	7	38016085	38016085	CG	38020608	4523
4856_3	7	38016977	38016977	CA	38020608	3631
4856_3	7	38017604	38017604	CT	38020608	3004
4856_3	7	38017732	38017732	CA	38020608	2876
4856_3	7	38018069	38018069	CT	38020608	2539
4856_3	3	85179930	85179930	TG	85180307	377
4856_3	19	17922639	17922639	CG	17925287	2648
4856_3	20	58584532	58584532	AC	58576752	7780
