sample	chr	start	end	score	breakpoint	diff
2457_1	9	105434810	105434810	GT	105432445	2365
2457_1	5	171229010	171229010	CG	171229009	1
2457_1	3	132233764	132233764	TA	132233765	1
2457_1	22	16428952	16428952	AG	16419741	9211
2457_1	2	40152389	40152389	GC	40151585	804
2457_1	19	37754421	37754421	GA	37762062	7641
2457_1	15	72088511	72088511	TC	72088838	327
2457_1	15	72088746	72088746	TG	72088838	92
2457_1	14	46225074	46225074	GT	46231288	6214
2457_1	13	90475963	90475963	TG	90479270	3307
2457_1	11	36036874	36036874	GT	36039408	2534
2457_1	11	37948648	37948648	CG	37941708	6940
2457_1	11	37948648	37948648	CG	37941710	6938
2457_1	1	536195	536195	TC	532681	3514
2457_3	9	68419563	68419563	TC	68423607	4044
2457_3	9	68422910	68422910	TC	68423607	697
2457_3	7	29724001	29724001	AC	29724000	1
2457_3	5	34210723	34210723	TG	34207378	3345
2457_3	5	49546052	49546052	CA	49547396	1344
2457_3	5	171229010	171229010	CG	171229009	1
2457_3	3	132233764	132233764	TA	132233765	1
2457_3	3	153615931	153615931	AC	153607553	8378
2457_3	22	16409835	16409835	TC	16419741	9906
2457_3	22	16428952	16428952	AG	16419741	9211
2457_3	21	9677653	9677653	GA	9676885	768
2457_3	2	40152389	40152389	GC	40151585	804
2457_3	2	40152389	40152389	GC	40151587	802
2457_3	19	37754421	37754421	GA	37762062	7641
2457_3	16	17655181	17655181	AT	17655184	3
2457_3	13	90475963	90475963	TG	90479270	3307
2457_3	11	37948648	37948648	CG	37941708	6940
2457_3	11	37948648	37948648	CG	37941710	6938
2457_3	10	59429942	59429942	GA	59429944	2
2457_3	10	122672798	122672798	GA	122670953	1845
2821B	X	22259294	22259294	TC	22258411	883
2821B	X	35637034	35637034	CT	35646713	9679
2821B	X	57154535	57154535	CA	57154534	1
2821B	9	117756262	117756262	AC	117765656	9394
2821B	8	60754190	60754190	CT	60746412	7778
2821B	8	94649608	94649608	CG	94650090	482
2821B	8	94649695	94649695	CG	94650090	395
2821B	8	94651652	94651652	GA	94650090	1562
2821B	8	128005279	128005279	AG	128014310	9031
2821B	8	130664901	130664901	AC	130664902	1
2821B	8	140728248	140728248	CT	140726019	2229
2821B	7	63437881	63437881	AC	63436714	1167
2821B	7	89029733	89029733	AT	89029731	2
2821B	7	128288267	128288267	AC	128297521	9254
2821B	6	20077638	20077638	CG	20079059	1421
2821B	6	41774684	41774684	GA	41766023	8661
2821B	6	43603890	43603890	GA	43597954	5936
2821B	6	43606400	43606400	GT	43597954	8446
2821B	6	69707226	69707226	AT	69708752	1526
2821B	6	113706699	113706699	TA	113706698	1
2821B	5	20883022	20883022	CA	20878302	4720
2821B	5	20883023	20883023	AG	20878302	4721
2821B	5	25903975	25903975	GT	25903973	2
2821B	5	27200432	27200432	TC	27190856	9576
2821B	5	86712619	86712619	AG	86707104	5515
2821B	5	146546950	146546950	AC	146541732	5218
2821B	5	152397465	152397465	CA	152407073	9608
2821B	5	154598788	154598788	GC	154601909	3121
2821B	5	163975242	163975242	GA	163975240	2
2821B	5	164637298	164637298	CT	164643201	5903
2821B	5	164642051	164642051	CA	164643201	1150
2821B	4	133437013	133437013	CT	133437014	1
2821B	21	11103524	11103524	GA	11094923	8601
2821B	20	52881738	52881738	GT	52878567	3171
2821B	2	34185520	34185520	GA	34182892	2628
2821B	2	57524229	57524229	CA	57524227	2
2821B	2	83628255	83628255	CA	83627482	773
2821B	2	83630118	83630118	GA	83627482	2636
2821B	2	102181292	102181292	CT	102180447	845
2821B	2	104465453	104465453	GA	104465452	1
2821B	2	114428732	114428732	CT	114427225	1507
2821B	2	133004729	133004729	AG	133004728	1
2821B	2	212921131	212921131	CG	212921247	116
2821B	19	32012242	32012242	CT	32012766	524
2821B	19	43644322	43644322	CT	43653374	9052
2821B	15	20561367	20561367	CT	20553517	7850
2821B	15	50331837	50331837	CT	50326070	5767
2821B	14	33728406	33728406	TA	33728409	3
2821B	13	75425265	75425265	CG	75425264	1
2821B	12	23942301	23942301	CT	23936179	6122
2821B	12	56592150	56592150	CG	56589015	3135
2821B	12	75576679	75576679	GA	75573574	3105
2821B	11	27691162	27691162	AT	27690400	762
2821B	11	27691162	27691162	AT	27691161	1
2821B	11	29545154	29545154	TC	29545305	151
2821B	11	60045249	60045249	CT	60040015	5234
2821B	11	62916463	62916463	CT	62924524	8061
2821B	11	62916621	62916621	CT	62924524	7903
2821B	11	62918016	62918016	GA	62924524	6508
2821B	11	62924725	62924725	CG	62924524	201
2821B	11	62916463	62916463	CT	62924525	8062
2821B	11	62916621	62916621	CT	62924525	7904
2821B	11	62918016	62918016	GA	62924525	6509
2821B	11	62924725	62924725	CG	62924525	200
2821B	11	77565002	77565002	TG	77565004	2
2821B	11	80283307	80283307	GT	80273449	9858
2821B	11	81084920	81084920	GC	81079371	5549
2821B	11	118375783	118375783	CT	118373905	1878
2821B	10	32722951	32722951	GT	32717087	5864
2821B	10	121289589	121289589	CT	121288166	1423
2821B	10	121289589	121289589	CT	121288167	1422
2821B	1	21830508	21830508	GC	21830509	1
2821B	1	68781418	68781418	TA	68781419	1
2821B	1	108746780	108746780	CG	108749142	2362
2821B	1	108746780	108746780	CG	108749143	2363
2821B	1	114456453	114456453	TA	114464391	7938
2821B	1	200672499	200672499	TA	200672498	1
2821B	1	243150414	243150414	AT	243150416	2
3311A_1	21	10475211	10475211	GC	10475210	1
3311A_3	9	138677275	138677275	AC	138677277	2
3326A_3	X	86746836	86746836	AC	86738640	8196
3326A_3	X	102557799	102557799	TC	102552827	4972
3326A_3	X	102557800	102557800	GA	102552827	4973
3326A_3	8	65153365	65153365	CA	65153367	2
3326A_3	8	87199020	87199020	GT	87199019	1
3326A_3	8	137251694	137251694	GC	137251693	1
3326A_3	7	17057773	17057773	AC	17057893	120
3326A_3	3	22300084	22300084	TC	22297728	2356
3326A_3	3	84699584	84699584	AC	84699582	2
3326A_3	3	163246935	163246935	CG	163246934	1
3326A_3	3	166590893	166590893	CT	166594796	3903
3326A_3	3	166590893	166590893	CT	166594918	4025
3326A_3	16	33754436	33754436	CT	33754650	214
3326A_3	12	67224683	67224683	GA	67223820	863
3326A_3	12	68819752	68819752	CG	68822328	2576
3326A_3	12	68819752	68819752	CG	68822330	2578
3326A_3	12	69703925	69703925	GA	69712606	8681
3326A_3	12	71150022	71150022	GT	71156075	6053
3326A_3	12	71456889	71456889	GA	71455490	1399
3326A_3	12	71456889	71456889	GA	71455492	1397
3326A_3	12	71493163	71493163	TA	71497463	4300
3326A_3	12	71493164	71493164	GA	71497463	4299
3326A_3	11	41653778	41653778	TA	41655913	2135
3326A_3	10	1345235	1345235	CT	1345481	246
3326A_3	10	1345236	1345236	TG	1345481	245
3326A_3	10	44434552	44434552	CA	44432049	2503
3326B_4	8	87199020	87199020	GT	87199019	1
3326B_4	7	17057773	17057773	AC	17057893	120
3326B_4	6	133491407	133491407	TA	133496966	5559
3326B_4	2	150168610	150168610	GC	150169249	639
3326B_4	19	8568042	8568042	TG	8568045	3
3326B_4	19	10278564	10278564	GC	10278563	1
3326B_4	18	1800269	1800269	GA	1794431	5838
3326B_4	12	69240927	69240927	CT	69237479	3448
3326B_4	12	69568717	69568717	CT	69561445	7272
3326B_4	12	69892165	69892165	GA	69900978	8813
3326B_4	12	69892643	69892643	GT	69900978	8335
3326B_4	12	101648333	101648333	GT	101653692	5359
3326B_4	12	123817754	123817754	GA	123817411	343
3326B_4	11	40447776	40447776	GA	40453740	5964
3326B_4	11	40448277	40448277	GC	40453740	5463
3326B_4	10	100901541	100901541	CG	100905471	3930
3326B_4	1	158936762	158936762	CT	158941215	4453
3326C	4	46798085	46798085	TA	46798086	1
3484	X	110791394	110791394	CT	110791395	1
3484	8	75434491	75434491	GC	75434492	1
3484	7	123399969	123399969	AC	123399971	2
3484	3	87069349	87069349	TA	87069348	1
3484	3	95377115	95377115	CA	95377116	1
3484	20	29642183	29642183	GT	29636461	5722
3484	2	1760762	1760762	AT	1760760	2
3484	2	185841372	185841372	TA	185841373	1
3484	19	24619651	24619651	CT	24620820	1169
3484	19	24619965	24619965	CT	24620820	855
3484	19	43875111	43875111	CT	43875110	1
3484	12	84424332	84424332	TC	84417741	6591
3484	11	4262858	4262858	GT	4262857	1
3484	10	5035604	5035604	TG	5030648	4956
3762A_1	4	33331478	33331478	GT	33331477	1
3762A_1	2	51530980	51530980	GA	51530605	375
3762A_1	2	63875201	63875201	GA	63882554	7353
3762A_1	2	98946190	98946190	CG	98938856	7334
3762A_1	11	63082313	63082313	CA	63082312	1
3762A_1	1	150325871	150325871	CT	150333329	7458
3762A_5	X	1507813	1507813	GT	1507812	1
3762A_5	8	895590	895590	CG	891504	4086
3762A_5	2	98946190	98946190	CG	98938856	7334
3762A_5	14	105844919	105844919	AG	105844921	2
3762A_5	12	7417659	7417659	CA	7426356	8697
3762A_5	1	195029927	195029927	TA	195026209	3718
3762B	2	50814576	50814576	TC	50814578	2
4043A_1	X	42845494	42845494	AG	42840821	4673
4043A_1	X	42845494	42845494	AG	42850912	5418
4043A_1	X	66105235	66105235	GA	66108166	2931
4043A_1	X	66107359	66107359	GC	66108166	807
4043A_1	X	66107553	66107553	GA	66108166	613
4043A_1	X	66105235	66105235	GA	66108167	2932
4043A_1	X	66107359	66107359	GC	66108167	808
4043A_1	X	66107553	66107553	GA	66108167	614
4043A_1	X	90544560	90544560	GT	90536009	8551
4043A_1	X	90544560	90544560	GT	90536673	7887
4043A_1	X	147566226	147566226	TC	147566229	3
4043A_1	9	68360751	68360751	TC	68364680	3929
4043A_1	8	53384168	53384168	GC	53384167	1
4043A_1	8	136467681	136467681	GA	136462586	5095
4043A_1	7	9887253	9887253	TG	9883106	4147
4043A_1	6	48726288	48726288	AT	48726720	432
4043A_1	6	122173919	122173919	AT	122182391	8472
4043A_1	6	122173919	122173919	AT	122182393	8474
4043A_1	5	55117954	55117954	CA	55117953	1
4043A_1	5	97094054	97094054	AG	97098732	4678
4043A_1	5	100488267	100488267	CT	100480522	7745
4043A_1	5	134695750	134695750	GT	134689712	6038
4043A_1	5	180073677	180073677	GT	180073676	1
4043A_1	4	107699758	107699758	AT	107699757	1
4043A_1	3	12622118	12622118	CT	12625597	3479
4043A_1	3	12624400	12624400	CT	12625597	1197
4043A_1	3	12624727	12624727	CT	12625597	870
4043A_1	3	12622118	12622118	CT	12625599	3481
4043A_1	3	12624400	12624400	CT	12625599	1199
4043A_1	3	12624727	12624727	CT	12625599	872
4043A_1	3	85137600	85137600	GA	85137962	362
4043A_1	3	160307211	160307211	TG	160300261	6950
4043A_1	3	163587058	163587058	TA	163589304	2246
4043A_1	3	177407646	177407646	GA	177411296	3650
4043A_1	3	177408264	177408264	GA	177411296	3032
4043A_1	3	177409937	177409937	GA	177411296	1359
4043A_1	21	23790857	23790857	CT	23790859	2
4043A_1	21	23798370	23798370	AG	23790859	7511
4043A_1	20	4987473	4987473	CT	4988902	1429
4043A_1	20	4993501	4993501	CT	4988902	4599
4043A_1	20	4993720	4993720	CT	4988902	4818
4043A_1	2	91789546	91789546	TC	91792477	2931
4043A_1	2	146033614	146033614	AG	146036059	2445
4043A_1	2	184813779	184813779	AC	184814961	1182
4043A_1	2	226128483	226128483	AC	226125602	2881
4043A_1	19	7560341	7560341	CT	7563040	2699
4043A_1	18	38107724	38107724	AG	38108358	634
4043A_1	18	38107978	38107978	TG	38108358	380
4043A_1	18	38110350	38110350	TA	38108358	1992
4043A_1	18	41332362	41332362	CG	41336175	3813
4043A_1	18	41335386	41335386	CG	41336175	789
4043A_1	18	41335907	41335907	CT	41336175	268
4043A_1	18	41332362	41332362	CG	41336176	3814
4043A_1	18	41335386	41335386	CG	41336176	790
4043A_1	18	41335907	41335907	CT	41336176	269
4043A_1	16	8566026	8566026	GT	8574374	8348
4043A_1	16	31356781	31356781	TC	31358432	1651
4043A_1	16	31359368	31359368	AC	31358432	936
4043A_1	16	31359369	31359369	AC	31358432	937
4043A_1	16	31356781	31356781	TC	31358434	1653
4043A_1	16	31359368	31359368	AC	31358434	934
4043A_1	16	31359369	31359369	AC	31358434	935
4043A_1	15	21317337	21317337	GT	21316268	1069
4043A_1	13	38161717	38161717	CA	38165351	3634
4043A_1	13	107556054	107556054	CT	107555447	607
4043A_1	1	12901938	12901938	TA	12901940	2
4043A_4	X	34446713	34446713	GA	34455179	8466
4043A_4	X	34453999	34453999	TC	34455179	1180
4043A_4	X	42845494	42845494	AG	42840821	4673
4043A_4	X	75257206	75257206	CG	75263180	5974
4043A_4	X	75257531	75257531	CT	75263180	5649
4043A_4	X	75272912	75272912	AG	75263180	9732
4043A_4	X	77922258	77922258	GT	77922259	1
4043A_4	X	78773622	78773622	GA	78774370	748
4043A_4	X	85253318	85253318	CT	85251755	1563
4043A_4	X	90544560	90544560	GT	90536009	8551
4043A_4	X	90544560	90544560	GT	90536673	7887
4043A_4	X	142413565	142413565	GC	142416279	2714
4043A_4	X	143335749	143335749	GA	143335368	381
4043A_4	X	147566226	147566226	TC	147566229	3
4043A_4	8	3821311	3821311	GA	3813331	7980
4043A_4	8	3821745	3821745	GA	3813331	8414
4043A_4	8	3823313	3823313	GA	3813331	9982
4043A_4	8	3821311	3821311	GA	3813332	7979
4043A_4	8	3821745	3821745	GA	3813332	8413
4043A_4	8	3823313	3823313	GA	3813332	9981
4043A_4	8	136467681	136467681	GA	136462586	5095
4043A_4	7	9887253	9887253	TG	9883106	4147
4043A_4	6	48087053	48087053	GA	48087051	2
4043A_4	6	48726288	48726288	AT	48726720	432
4043A_4	5	29248306	29248306	AG	29244476	3830
4043A_4	5	55117954	55117954	CA	55117953	1
4043A_4	5	100488267	100488267	CT	100480522	7745
4043A_4	5	134695750	134695750	GT	134689712	6038
4043A_4	4	117588432	117588432	GA	117583406	5026
4043A_4	3	14982117	14982117	GC	14985632	3515
4043A_4	3	14984723	14984723	GT	14985632	909
4043A_4	3	54721960	54721960	AG	54727077	5117
4043A_4	3	65149295	65149295	CA	65151100	1805
4043A_4	3	65149295	65149295	CA	65151101	1806
4043A_4	3	118660829	118660829	AC	118652317	8512
4043A_4	3	160307211	160307211	TG	160300261	6950
4043A_4	3	163587058	163587058	TA	163589304	2246
4043A_4	3	173702891	173702891	CT	173703141	250
4043A_4	3	197851680	197851680	TC	197855287	3607
4043A_4	3	197864997	197864997	CG	197855287	9710
4043A_4	21	23790857	23790857	CT	23790859	2
4043A_4	21	23798370	23798370	AG	23790859	7511
4043A_4	20	43765804	43765804	TG	43765975	171
4043A_4	20	50721612	50721612	GA	50721172	440
4043A_4	2	91789546	91789546	TC	91792477	2931
4043A_4	2	146033614	146033614	AG	146036059	2445
4043A_4	2	184813779	184813779	AC	184814961	1182
4043A_4	19	3217420	3217420	GA	3215722	1698
4043A_4	19	3217764	3217764	GA	3215722	2042
4043A_4	19	3218259	3218259	GA	3215722	2537
4043A_4	18	38107724	38107724	AG	38108358	634
4043A_4	18	38107978	38107978	TG	38108358	380
4043A_4	18	38110350	38110350	TA	38108358	1992
4043A_4	18	52452751	52452751	CT	52459057	6306
4043A_4	18	59542579	59542579	GA	59543353	774
4043A_4	18	59552102	59552102	CT	59543353	8749
4043A_4	18	59607676	59607676	GA	59617372	9696
4043A_4	18	59608956	59608956	GT	59617372	8416
4043A_4	18	59609127	59609127	GA	59617372	8245
4043A_4	18	59615748	59615748	GA	59617372	1624
4043A_4	18	59616071	59616071	GT	59617372	1301
4043A_4	18	59616748	59616748	GA	59617372	624
4043A_4	18	59624814	59624814	CA	59617372	7442
4043A_4	18	68155238	68155238	GT	68160861	5623
4043A_4	18	68158478	68158478	GA	68160861	2383
4043A_4	18	68159718	68159718	GA	68160861	1143
4043A_4	18	68160235	68160235	GC	68160861	626
4043A_4	18	68161648	68161648	GA	68160861	787
4043A_4	18	68162823	68162823	GA	68160861	1962
4043A_4	18	69394630	69394630	GT	69394631	1
4043A_4	16	21739249	21739249	CT	21737204	2045
4043A_4	16	77963172	77963172	GA	77963174	2
4043A_4	13	107556054	107556054	CT	107555447	607
4043A_4	12	4509973	4509973	TC	4501647	8326
4043A_4	12	63186577	63186577	CA	63195546	8969
4043A_4	12	63187962	63187962	CT	63195546	7584
4043A_4	12	63190416	63190416	CT	63195546	5130
4043A_4	12	70566745	70566745	GA	70567501	756
4043A_4	11	103926501	103926501	GA	103926640	139
4043A_4	1	145091678	145091678	CT	145084896	6782
4333	6	97434945	97434945	TC	97434944	1
4333	5	175437414	175437414	CG	175439831	2417
4333	3	186789303	186789303	TC	186793680	4377
4333	11	100285415	100285415	TC	100275556	9859
4333	10	114404351	114404351	GA	114404353	2
4633A_A-S2	9	24908667	24908667	AC	24908669	2
4633A_A-S2	9	69736069	69736069	TG	69737653	1584
4633A_A-S2	7	47152143	47152143	CA	47152144	1
4633A_A-S2	2	87585027	87585027	CT	87592002	6975
4633A_A-S2	1	120605778	120605778	CT	120607214	1436
4633A_B-S3	4	39637256	39637256	TA	39630752	6504
4633A_B-S3	2	216627181	216627181	AT	216627179	2
4633A_B-S3	18	12431488	12431488	GC	12431490	2
4633A_B-S3	11	61324132	61324132	TG	61324131	1
4633A_B-S3	11	76583269	76583269	TA	76583270	1
4633A_C-S4	10	35094490	35094490	TC	35094493	3
4633A_C-S4	1	22335578	22335578	GC	22335576	2
4633B_C-S5	4	143233877	143233877	GT	143233876	1
4633B_C-S5	2	50814576	50814576	TC	50814578	2
4856_1	X	142917566	142917566	GA	142917166	400
4856_1	X	144782285	144782285	AT	144778639	3646
4856_1	X	149016418	149016418	GT	149025394	8976
4856_1	X	150079613	150079613	AG	150080196	583
4856_1	9	91624438	91624438	CT	91624437	1
4856_1	8	89944551	89944551	AC	89944553	2
4856_1	8	94438766	94438766	GA	94431458	7308
4856_1	8	112965042	112965042	TC	112965041	1
4856_1	7	42521191	42521191	GC	42521192	1
4856_1	7	150457897	150457897	TC	150457896	1
4856_1	5	19244583	19244583	GC	19253787	9204
4856_1	5	19247631	19247631	AT	19253787	6156
4856_1	5	20938066	20938066	TG	20939724	1658
4856_1	5	20993103	20993103	GA	21002843	9740
4856_1	5	22440116	22440116	TG	22442609	2493
4856_1	4	11872931	11872931	TA	11874989	2058
4856_1	4	15412683	15412683	TC	15412682	1
4856_1	4	156427568	156427568	GA	156434493	6925
4856_1	3	27051302	27051302	GA	27049230	2072
4856_1	3	77157615	77157615	GA	77159847	2232
4856_1	3	89800209	89800209	TA	89800208	1
4856_1	3	125720864	125720864	CG	125721269	405
4856_1	3	125720864	125720864	CG	125721271	407
4856_1	21	22337921	22337921	TC	22339431	1510
4856_1	21	36841317	36841317	GA	36832022	9295
4856_1	20	58011086	58011086	GA	58003245	7841
4856_1	2	10815459	10815459	CA	10815458	1
4856_1	2	57444977	57444977	AG	57443055	1922
4856_1	2	57449669	57449669	AT	57443055	6614
4856_1	2	78761208	78761208	AG	78757114	4094
4856_1	2	131804176	131804176	CT	131801287	2889
4856_1	19	11502453	11502453	TA	11502666	213
4856_1	19	14510370	14510370	CT	14517010	6640
4856_1	19	17922639	17922639	CG	17925288	2649
4856_1	19	41371790	41371790	GC	41371789	1
4856_1	18	12999455	12999455	CA	12993174	6281
4856_1	18	27964797	27964797	CG	27967968	3171
4856_1	18	43281211	43281211	TG	43275301	5910
4856_1	18	59235653	59235653	CT	59235238	415
4856_1	17	5745647	5745647	CT	5736923	8724
4856_1	15	39339293	39339293	CG	39340064	771
4856_1	14	84284983	84284983	TA	84292183	7200
4856_1	14	92516487	92516487	CT	92516486	1
4856_1	13	41487706	41487706	GC	41487705	1
4856_1	13	95060079	95060079	CG	95054181	5898
4856_1	12	15043039	15043039	TG	15041938	1101
4856_1	12	60810937	60810937	AT	60816239	5302
4856_1	12	73583796	73583796	AT	73591742	7946
4856_1	12	103312493	103312493	CT	103318138	5645
4856_1	11	41901311	41901311	AG	41908612	7301
4856_1	11	81442589	81442589	TA	81442588	1
4856_1	10	87677018	87677018	TC	87677017	1
4856_1	10	122921507	122921507	GA	122919843	1664
4856_1	1	59983550	59983550	GT	59988982	5432
4856_1	1	197087232	197087232	TC	197082121	5111
4856_3	X	58303896	58303896	TA	58312711	8815
4856_3	X	81805481	81805481	GT	81796354	9127
4856_3	X	81805482	81805482	TG	81796354	9128
4856_3	X	98942574	98942574	AC	98947096	4522
4856_3	X	144782285	144782285	AT	144778639	3646
4856_3	X	149016418	149016418	GT	149025394	8976
4856_3	X	149020422	149020422	AG	149025394	4972
4856_3	9	9936000	9936000	GA	9935375	625
4856_3	9	69789335	69789335	TC	69796844	7509
4856_3	9	91624438	91624438	CT	91624437	1
4856_3	8	2286488	2286488	CT	2284781	1707
4856_3	8	12871331	12871331	GA	12874586	3255
4856_3	8	14640192	14640192	GA	14640190	2
4856_3	8	76195180	76195180	GT	76199842	4662
4856_3	8	84401139	84401139	TG	84395502	5637
4856_3	8	85920916	85920916	GC	85930591	9675
4856_3	8	85926344	85926344	TG	85930591	4247
4856_3	8	85926345	85926345	CT	85930591	4246
4856_3	8	85927043	85927043	AC	85930591	3548
4856_3	8	87157081	87157081	AG	87165982	8901
4856_3	8	94438766	94438766	GA	94431458	7308
4856_3	8	112965042	112965042	TC	112965041	1
4856_3	8	120871858	120871858	GT	120865124	6734
4856_3	7	3573456	3573456	GA	3568681	4775
4856_3	7	42332760	42332760	CT	42333532	772
4856_3	7	42333137	42333137	CG	42333532	395
4856_3	7	51960718	51960718	GA	51958511	2207
4856_3	7	61549892	61549892	TC	61558181	8289
4856_3	7	61556185	61556185	GC	61558181	1996
4856_3	7	61780752	61780752	GA	61783994	3242
4856_3	7	61781837	61781837	TC	61783994	2157
4856_3	7	61784950	61784950	AC	61783994	956
4856_3	7	61788245	61788245	GA	61783994	4251
4856_3	7	76686666	76686666	TA	76695622	8956
4856_3	7	82530929	82530929	GT	82535322	4393
4856_3	7	149700505	149700505	TA	149703282	2777
4856_3	7	150457897	150457897	TC	150457896	1
4856_3	6	66682340	66682340	GC	66685480	3140
4856_3	6	72213723	72213723	GA	72213964	241
4856_3	6	72213723	72213723	GA	72213966	243
4856_3	6	107797475	107797475	TA	107797474	1
4856_3	6	110904305	110904305	CT	110897828	6477
4856_3	6	146173923	146173923	GA	146173780	143
4856_3	6	149167156	149167156	CA	149174090	6934
4856_3	5	20921320	20921320	TC	20922085	765
4856_3	5	20938066	20938066	TG	20939724	1658
4856_3	5	21482446	21482446	GT	21489241	6795
4856_3	5	22440116	22440116	TG	22442609	2493
4856_3	5	53283793	53283793	CG	53283960	167
4856_3	5	77303614	77303614	TA	77311118	7504
4856_3	5	77303616	77303616	CA	77311118	7502
4856_3	5	130365390	130365390	TG	130372662	7272
4856_3	4	15412683	15412683	TC	15412682	1
4856_3	4	61227058	61227058	AG	61233255	6197
4856_3	4	61241834	61241834	GA	61233255	8579
4856_3	4	85824070	85824070	CG	85826334	2264
4856_3	4	101825463	101825463	CT	101831693	6230
4856_3	4	118301272	118301272	TC	118301270	2
4856_3	4	142800441	142800441	CT	142797580	2861
4856_3	4	146367286	146367286	CT	146360893	6393
4856_3	4	161625701	161625701	GA	161626701	1000
4856_3	4	190200475	190200475	GA	190198543	1932
4856_3	4	190202090	190202090	GA	190198543	3547
4856_3	3	28170827	28170827	CT	28168237	2590
4856_3	3	88662110	88662110	GT	88667918	5808
4856_3	3	88662111	88662111	CT	88667918	5807
4856_3	3	88667920	88667920	AT	88667918	2
4856_3	3	89800209	89800209	TA	89800208	1
4856_3	3	125720864	125720864	CG	125721269	405
4856_3	3	156901561	156901561	CT	156907263	5702
4856_3	3	160393653	160393653	AG	160400191	6538
4856_3	3	162937800	162937800	CG	162945491	7691
4856_3	21	22308108	22308108	AG	22302366	5742
4856_3	21	22337921	22337921	TC	22339431	1510
4856_3	20	58011086	58011086	GA	58003245	7841
4856_3	20	61506000	61506000	CT	61513942	7942
4856_3	2	10380703	10380703	CA	10377638	3065
4856_3	2	10815459	10815459	CA	10815458	1
4856_3	2	33780512	33780512	CG	33771787	8725
4856_3	2	57444977	57444977	AG	57443055	1922
4856_3	2	57449669	57449669	AT	57443055	6614
4856_3	2	78761208	78761208	AG	78757114	4094
4856_3	2	124944134	124944134	CA	124951979	7845
4856_3	2	131804176	131804176	CT	131800689	3487
4856_3	2	131804176	131804176	CT	131801287	2889
4856_3	2	139287106	139287106	TG	139287105	1
4856_3	2	142461618	142461618	CG	142466934	5316
4856_3	2	143692275	143692275	AT	143700991	8716
4856_3	2	151221615	151221615	TC	151224154	2539
4856_3	2	173282025	173282025	GA	173276372	5653
4856_3	2	214236383	214236383	AG	214239345	2962
4856_3	19	8371947	8371947	GT	8371949	2
4856_3	18	12999455	12999455	CA	12993174	6281
4856_3	17	5745647	5745647	CT	5736923	8724
4856_3	15	20529526	20529526	GA	20523515	6011
4856_3	15	20533043	20533043	GA	20523515	9528
4856_3	15	20529526	20529526	GA	20527370	2156
4856_3	15	20533043	20533043	GA	20527370	5673
4856_3	15	22314001	22314001	CA	22312410	1591
4856_3	15	39296013	39296013	CT	39294803	1210
4856_3	15	39339293	39339293	CG	39340064	771
4856_3	15	53927729	53927729	GA	53921178	6551
4856_3	15	92702738	92702738	CT	92698872	3866
4856_3	14	84284983	84284983	TA	84292183	7200
4856_3	14	92516487	92516487	CT	92516486	1
4856_3	13	66696627	66696627	GA	66694385	2242
4856_3	13	75276985	75276985	GA	75279782	2797
4856_3	13	95060079	95060079	CG	95054181	5898
4856_3	13	104124908	104124908	AG	104130217	5309
4856_3	12	719921	719921	CA	717672	2249
4856_3	12	50153568	50153568	AG	50153566	2
4856_3	12	59848982	59848982	AT	59848980	2
4856_3	12	60810937	60810937	AT	60816239	5302
4856_3	12	68163704	68163704	CA	68167524	3820
4856_3	12	73583796	73583796	AT	73591742	7946
4856_3	12	78340508	78340508	AC	78350506	9998
4856_3	12	82463969	82463969	AT	82462021	1948
4856_3	11	41901311	41901311	AG	41908612	7301
4856_3	11	81442589	81442589	TA	81442588	1
4856_3	11	133350211	133350211	GA	133359748	9537
4856_3	10	1302603	1302603	AG	1300526	2077
4856_3	10	1302603	1302603	AG	1304339	1736
4856_3	10	42850056	42850056	AG	42843305	6751
4856_3	10	42850056	42850056	AG	42843306	6750
4856_3	10	47121727	47121727	GA	47127765	6038
4856_3	1	3729907	3729907	CT	3723079	6828
4856_3	1	57279112	57279112	CT	57270408	8704
4856_3	1	118826325	118826325	CA	118829721	3396
4856_3	1	118826873	118826873	GA	118829721	2848
4856_3	1	118827107	118827107	CA	118829721	2614
4856_3	1	118826325	118826325	CA	118829723	3398
4856_3	1	118826873	118826873	GA	118829723	2850
4856_3	1	118827107	118827107	CA	118829723	2616
4856_3	1	197087232	197087232	TC	197082121	5111
4856_3	1	219439980	219439980	AG	219432751	7229
