sample	chr	start	end	score	breakpoint	diff
2457_1	5	171229010	171229010	CG	171229009	1
2457_1	3	132233764	132233764	TA	132233765	1
2457_1	2	40152389	40152389	GC	40151585	804
2457_1	15	72088511	72088511	TC	72088838	327
2457_1	15	72088746	72088746	TG	72088838	92
2457_3	9	68422910	68422910	TC	68423607	697
2457_3	7	29724001	29724001	AC	29724000	1
2457_3	5	171229010	171229010	CG	171229009	1
2457_3	3	132233764	132233764	TA	132233765	1
2457_3	21	9677653	9677653	GA	9676885	768
2457_3	2	40152389	40152389	GC	40151585	804
2457_3	2	40152389	40152389	GC	40151587	802
2457_3	16	17655181	17655181	AT	17655184	3
2457_3	10	59429942	59429942	GA	59429944	2
2821B	X	22259294	22259294	TC	22258411	883
2821B	X	57154535	57154535	CA	57154534	1
2821B	8	94649608	94649608	CG	94650090	482
2821B	8	94649695	94649695	CG	94650090	395
2821B	8	130664901	130664901	AC	130664902	1
2821B	7	89029733	89029733	AT	89029731	2
2821B	6	113706699	113706699	TA	113706698	1
2821B	5	25903975	25903975	GT	25903973	2
2821B	5	163975242	163975242	GA	163975240	2
2821B	4	133437013	133437013	CT	133437014	1
2821B	2	57524229	57524229	CA	57524227	2
2821B	2	83628255	83628255	CA	83627482	773
2821B	2	102181292	102181292	CT	102180447	845
2821B	2	104465453	104465453	GA	104465452	1
2821B	2	133004729	133004729	AG	133004728	1
2821B	2	212921131	212921131	CG	212921247	116
2821B	19	32012242	32012242	CT	32012766	524
2821B	14	33728406	33728406	TA	33728409	3
2821B	13	75425265	75425265	CG	75425264	1
2821B	11	27691162	27691162	AT	27690400	762
2821B	11	27691162	27691162	AT	27691161	1
2821B	11	29545154	29545154	TC	29545305	151
2821B	11	62924725	62924725	CG	62924524	201
2821B	11	62924725	62924725	CG	62924525	200
2821B	11	77565002	77565002	TG	77565004	2
2821B	1	21830508	21830508	GC	21830509	1
2821B	1	68781418	68781418	TA	68781419	1
2821B	1	200672499	200672499	TA	200672498	1
2821B	1	243150414	243150414	AT	243150416	2
3311A_1	21	10475211	10475211	GC	10475210	1
3311A_3	9	138677275	138677275	AC	138677277	2
3326A_3	8	65153365	65153365	CA	65153367	2
3326A_3	8	87199020	87199020	GT	87199019	1
3326A_3	8	137251694	137251694	GC	137251693	1
3326A_3	7	17057773	17057773	AC	17057893	120
3326A_3	3	84699584	84699584	AC	84699582	2
3326A_3	3	163246935	163246935	CG	163246934	1
3326A_3	16	33754436	33754436	CT	33754650	214
3326A_3	12	67224683	67224683	GA	67223820	863
3326A_3	10	1345235	1345235	CT	1345481	246
3326A_3	10	1345236	1345236	TG	1345481	245
3326B_4	8	87199020	87199020	GT	87199019	1
3326B_4	7	17057773	17057773	AC	17057893	120
3326B_4	2	150168610	150168610	GC	150169249	639
3326B_4	19	8568042	8568042	TG	8568045	3
3326B_4	19	10278564	10278564	GC	10278563	1
3326B_4	12	123817754	123817754	GA	123817411	343
3326C	4	46798085	46798085	TA	46798086	1
3484	X	110791394	110791394	CT	110791395	1
3484	8	75434491	75434491	GC	75434492	1
3484	7	123399969	123399969	AC	123399971	2
3484	3	87069349	87069349	TA	87069348	1
3484	3	95377115	95377115	CA	95377116	1
3484	2	1760762	1760762	AT	1760760	2
3484	2	185841372	185841372	TA	185841373	1
3484	19	24619965	24619965	CT	24620820	855
3484	19	43875111	43875111	CT	43875110	1
3484	11	4262858	4262858	GT	4262857	1
3762A_1	4	33331478	33331478	GT	33331477	1
3762A_1	2	51530980	51530980	GA	51530605	375
3762A_1	11	63082313	63082313	CA	63082312	1
3762A_5	X	1507813	1507813	GT	1507812	1
3762A_5	14	105844919	105844919	AG	105844921	2
3762B	2	50814576	50814576	TC	50814578	2
4043A_1	X	66107359	66107359	GC	66108166	807
4043A_1	X	66107553	66107553	GA	66108166	613
4043A_1	X	66107359	66107359	GC	66108167	808
4043A_1	X	66107553	66107553	GA	66108167	614
4043A_1	X	147566226	147566226	TC	147566229	3
4043A_1	8	53384168	53384168	GC	53384167	1
4043A_1	6	48726288	48726288	AT	48726720	432
4043A_1	5	55117954	55117954	CA	55117953	1
4043A_1	5	180073677	180073677	GT	180073676	1
4043A_1	4	107699758	107699758	AT	107699757	1
4043A_1	3	12624727	12624727	CT	12625597	870
4043A_1	3	12624727	12624727	CT	12625599	872
4043A_1	3	85137600	85137600	GA	85137962	362
4043A_1	21	23790857	23790857	CT	23790859	2
4043A_1	18	38107724	38107724	AG	38108358	634
4043A_1	18	38107978	38107978	TG	38108358	380
4043A_1	18	41335386	41335386	CG	41336175	789
4043A_1	18	41335907	41335907	CT	41336175	268
4043A_1	18	41335386	41335386	CG	41336176	790
4043A_1	18	41335907	41335907	CT	41336176	269
4043A_1	16	31359368	31359368	AC	31358432	936
4043A_1	16	31359369	31359369	AC	31358432	937
4043A_1	16	31359368	31359368	AC	31358434	934
4043A_1	16	31359369	31359369	AC	31358434	935
4043A_1	13	107556054	107556054	CT	107555447	607
4043A_1	1	12901938	12901938	TA	12901940	2
4043A_4	X	77922258	77922258	GT	77922259	1
4043A_4	X	78773622	78773622	GA	78774370	748
4043A_4	X	143335749	143335749	GA	143335368	381
4043A_4	X	147566226	147566226	TC	147566229	3
4043A_4	6	48087053	48087053	GA	48087051	2
4043A_4	6	48726288	48726288	AT	48726720	432
4043A_4	5	55117954	55117954	CA	55117953	1
4043A_4	3	14984723	14984723	GT	14985632	909
4043A_4	3	173702891	173702891	CT	173703141	250
4043A_4	21	23790857	23790857	CT	23790859	2
4043A_4	20	43765804	43765804	TG	43765975	171
4043A_4	20	50721612	50721612	GA	50721172	440
4043A_4	18	38107724	38107724	AG	38108358	634
4043A_4	18	38107978	38107978	TG	38108358	380
4043A_4	18	59542579	59542579	GA	59543353	774
4043A_4	18	59616748	59616748	GA	59617372	624
4043A_4	18	68160235	68160235	GC	68160861	626
4043A_4	18	68161648	68161648	GA	68160861	787
4043A_4	18	69394630	69394630	GT	69394631	1
4043A_4	16	77963172	77963172	GA	77963174	2
4043A_4	13	107556054	107556054	CT	107555447	607
4043A_4	12	70566745	70566745	GA	70567501	756
4043A_4	11	103926501	103926501	GA	103926640	139
4333	6	97434945	97434945	TC	97434944	1
4333	10	114404351	114404351	GA	114404353	2
4633A_A-S2	9	24908667	24908667	AC	24908669	2
4633A_A-S2	7	47152143	47152143	CA	47152144	1
4633A_B-S3	2	216627181	216627181	AT	216627179	2
4633A_B-S3	18	12431488	12431488	GC	12431490	2
4633A_B-S3	11	61324132	61324132	TG	61324131	1
4633A_B-S3	11	76583269	76583269	TA	76583270	1
4633A_C-S4	10	35094490	35094490	TC	35094493	3
4633A_C-S4	1	22335578	22335578	GC	22335576	2
4633B_C-S5	4	143233877	143233877	GT	143233876	1
4633B_C-S5	2	50814576	50814576	TC	50814578	2
4856_1	X	142917566	142917566	GA	142917166	400
4856_1	X	150079613	150079613	AG	150080196	583
4856_1	9	91624438	91624438	CT	91624437	1
4856_1	8	89944551	89944551	AC	89944553	2
4856_1	8	112965042	112965042	TC	112965041	1
4856_1	7	42521191	42521191	GC	42521192	1
4856_1	7	150457897	150457897	TC	150457896	1
4856_1	4	15412683	15412683	TC	15412682	1
4856_1	3	89800209	89800209	TA	89800208	1
4856_1	3	125720864	125720864	CG	125721269	405
4856_1	3	125720864	125720864	CG	125721271	407
4856_1	2	10815459	10815459	CA	10815458	1
4856_1	19	11502453	11502453	TA	11502666	213
4856_1	19	41371790	41371790	GC	41371789	1
4856_1	18	59235653	59235653	CT	59235238	415
4856_1	15	39339293	39339293	CG	39340064	771
4856_1	14	92516487	92516487	CT	92516486	1
4856_1	13	41487706	41487706	GC	41487705	1
4856_1	11	81442589	81442589	TA	81442588	1
4856_1	10	87677018	87677018	TC	87677017	1
4856_3	9	9936000	9936000	GA	9935375	625
4856_3	9	91624438	91624438	CT	91624437	1
4856_3	8	14640192	14640192	GA	14640190	2
4856_3	8	112965042	112965042	TC	112965041	1
4856_3	7	42332760	42332760	CT	42333532	772
4856_3	7	42333137	42333137	CG	42333532	395
4856_3	7	61784950	61784950	AC	61783994	956
4856_3	7	150457897	150457897	TC	150457896	1
4856_3	6	72213723	72213723	GA	72213964	241
4856_3	6	72213723	72213723	GA	72213966	243
4856_3	6	107797475	107797475	TA	107797474	1
4856_3	6	146173923	146173923	GA	146173780	143
4856_3	5	20921320	20921320	TC	20922085	765
4856_3	5	53283793	53283793	CG	53283960	167
4856_3	4	15412683	15412683	TC	15412682	1
4856_3	4	118301272	118301272	TC	118301270	2
4856_3	3	88667920	88667920	AT	88667918	2
4856_3	3	89800209	89800209	TA	89800208	1
4856_3	3	125720864	125720864	CG	125721269	405
4856_3	2	10815459	10815459	CA	10815458	1
4856_3	2	139287106	139287106	TG	139287105	1
4856_3	19	8371947	8371947	GT	8371949	2
4856_3	15	39339293	39339293	CG	39340064	771
4856_3	14	92516487	92516487	CT	92516486	1
4856_3	12	50153568	50153568	AG	50153566	2
4856_3	12	59848982	59848982	AT	59848980	2
4856_3	11	81442589	81442589	TA	81442588	1
