sample	chr	start	end	score	breakpoint	diff
2457_1	14	106084734	106084734	GA	106085712	978
2457_1	2	40152389	40152389	GC	40151586	803
2457_1	11	34993933	34993933	CT	34993932	1
2457_1	2	40152389	40152389	GC	40152494	105
2457_1	20	52271930	52271930	GA	52271524	406
2457_3	3	55731676	55731676	CA	55731980	304
2457_3	14	106086698	106086698	CT	106085709	989
2457_3	2	40152389	40152389	GC	40151586	803
2457_3	11	34993933	34993933	CT	34993932	1
2457_3	11	35083460	35083460	GA	35082961	499
2457_3	2	40152389	40152389	GC	40152573	184
2457_3	2	40152389	40152389	GC	40151582	807
2821B	2	3277502	3277502	AG	3277782	280
2821B	8	94649608	94649608	CG	94650090	482
2821B	8	94649695	94649695	CG	94650090	395
2821B	17	67943188	67943188	GA	67943631	443
2821B	8	69699184	69699184	GC	69699091	93
2821B	8	69700042	69700042	GA	69699091	951
2821B	8	84499330	84499330	GC	84498628	702
2821B	8	91833539	91833539	AG	91833476	63
2821B	11	61350479	61350479	CT	61351356	877
2821B	1	223923779	223923779	TG	223923144	635
2821B	3	137112961	137112961	TA	137112997	36
2821B	5	101175061	101175061	CG	101175195	134
2821B	5	117578475	117578475	CT	117579092	617
2821B	5	117578477	117578477	CT	117579092	615
2821B	6	74163147	74163147	CG	74162855	292
2821B	7	47502385	47502385	TC	47502217	168
2821B	7	73510455	73510455	TC	73510310	145
2821B	8	91750271	91750271	AT	91750284	13
2821B	8	91833539	91833539	AG	91834202	663
2821B	8	130664901	130664901	AC	130664506	395
2821B	11	59928843	59928843	GC	59928414	429
2821B	11	62924725	62924725	CG	62924635	90
2821B	12	71331834	71331834	GT	71331945	111
2821B	16	58776882	58776882	GC	58776403	479
2821B	17	67943188	67943188	GA	67944116	928
2821B	19	53234561	53234561	TC	53234764	203
2821B	19	53234562	53234562	TC	53234764	202
2821B	20	33911429	33911429	GT	33910541	888
2821B	4	165443043	165443043	CT	165443318	275
2821B	8	81903176	81903176	CG	81903363	187
2821B	7	101458364	101458364	CT	101458925	561
2821B	11	61350479	61350479	CT	61351089	610
2821B	8	57318263	57318263	GC	57317901	362
2821B	8	57318556	57318556	GA	57317901	655
2821B	20	16119201	16119201	CG	16119380	179
4043A_1	6	65178216	65178216	CT	65178445	229
4043A_1	8	3822622	3822622	GA	3823539	917
4043A_1	8	3823313	3823313	GA	3823539	226
4043A_1	12	28320704	28320704	CT	28320820	116
4043A_1	12	70566745	70566745	GA	70567500	755
4043A_1	18	59616748	59616748	GA	59617380	632
4043A_1	18	68164229	68164229	AG	68164051	178
4043A_1	X	75502189	75502189	GC	75501680	509
4043A_1	X	75505689	75505689	TG	75505936	247
4043A_1	X	78612735	78612735	GA	78613588	853
4043A_1	X	78773622	78773622	GA	78774370	748
4043A_1	2	146033614	146033614	AG	146033456	158
4043A_1	3	173702891	173702891	CT	173702579	312
4043A_1	3	173702891	173702891	CT	173702595	296
4043A_1	5	153190756	153190756	GT	153190722	34
4043A_1	6	65178216	65178216	CT	65178037	179
4043A_1	8	2638438	2638438	CG	2638217	221
4043A_1	9	22052086	22052086	CT	22051965	121
4043A_1	12	648079	648079	CT	647696	383
4043A_1	12	17058657	17058657	GC	17059300	643
4043A_1	12	28335830	28335830	CT	28335770	60
4043A_1	17	27314719	27314719	CT	27314164	555
4043A_1	17	38412389	38412389	AG	38412225	164
4043A_1	18	21069329	21069329	TA	21068381	948
4043A_1	18	59840899	59840899	GA	59841170	271
4043A_1	18	68164229	68164229	AG	68164027	202
4043A_1	X	66107359	66107359	GC	66108353	994
4043A_1	X	66107553	66107553	GA	66108353	800
4043A_1	X	80677492	80677492	GA	80677164	328
4043A_1	3	12624727	12624727	CT	12625597	870
4043A_1	3	173702891	173702891	CT	173703163	272
4043A_1	3	186788672	186788672	GA	186788422	250
4043A_1	3	186789280	186789280	GA	186788422	858
4043A_1	8	3821311	3821311	GA	3820855	456
4043A_1	8	3821745	3821745	GA	3820855	890
4043A_1	8	3823313	3823313	GA	3823968	655
4043A_1	10	46073364	46073364	GA	46073835	471
4043A_1	12	55685330	55685330	CA	55685881	551
4043A_1	12	91804816	91804816	GC	91804096	720
4043A_1	12	118016361	118016361	CG	118016441	80
4043A_1	18	41335386	41335386	CG	41336176	790
4043A_1	18	41335907	41335907	CT	41336176	269
4043A_1	18	52452751	52452751	CT	52452916	165
4043A_1	18	52452751	52452751	CT	52453540	789
4043A_1	18	55146302	55146302	GT	55145495	807
4043A_1	18	57653422	57653422	GA	57652859	563
4043A_1	18	57658766	57658766	GT	57659722	956
4043A_1	18	57660408	57660408	GA	57659722	686
4043A_1	18	59839986	59839986	GC	59840432	446
4043A_1	18	59840899	59840899	GA	59840432	467
4043A_1	18	59840899	59840899	GA	59841323	424
4043A_1	18	62000351	62000351	CT	61999857	494
4043A_1	18	68160235	68160235	GC	68160861	626
4043A_1	18	68161648	68161648	GA	68160861	787
4043A_1	19	3644140	3644140	CT	3644441	301
4043A_1	21	23579712	23579712	CA	23579784	72
4043A_1	21	23579712	23579712	CA	23580527	815
4043A_1	X	65955745	65955745	GC	65955478	267
4043A_1	X	73912331	73912331	GA	73912638	307
4043A_1	X	73913331	73913331	GA	73912638	693
4043A_1	X	78150321	78150321	CA	78150337	16
4043A_1	X	78150371	78150371	CT	78150337	34
4043A_1	6	65178216	65178216	CT	65178027	189
4043A_1	8	3821311	3821311	GA	3821605	294
4043A_1	8	3821745	3821745	GA	3821605	140
4043A_1	7	62510168	62510168	CA	62510471	303
4043A_1	7	62510573	62510573	GC	62510471	102
4043A_1	8	3596387	3596387	AT	3595996	391
4043A_1	11	40569586	40569586	CG	40569794	208
4043A_1	11	267825	267825	GA	267737	88
4043A_1	12	83561498	83561498	CT	83561745	247
4043A_1	11	281609	281609	GT	281805	196
4043A_1	12	118016361	118016361	CG	118015681	680
4043A_1	12	122709242	122709242	GA	122709677	435
4043A_1	11	281609	281609	GT	281452	157
4043A_1	14	105316575	105316575	GA	105317065	490
4043A_1	16	16011808	16011808	CG	16011594	214
4043A_1	11	60539819	60539819	CT	60540006	187
4043A_1	16	16013449	16013449	CT	16013466	17
4043A_1	18	45599775	45599775	CT	45600597	822
4043A_1	18	45600112	45600112	CA	45600597	485
4043A_1	12	27910895	27910895	AC	27911074	179
4043A_1	12	27910895	27910895	AC	27910889	6
4043A_1	18	52452751	52452751	CT	52452052	699
4043A_1	3	173702891	173702891	CT	173703142	251
4043A_1	3	173702891	173702891	CT	173702554	337
4043A_1	3	173702891	173702891	CT	173703053	162
4043A_1	18	57666491	57666491	GC	57667334	843
4043A_1	3	173702891	173702891	CT	173703087	196
4043A_1	12	27910895	27910895	AC	27910924	29
4043A_1	12	27910895	27910895	AC	27910888	7
4043A_1	12	27910895	27910895	AC	27910985	90
4043A_1	18	69461444	69461444	CT	69461191	253
4043A_1	18	77690728	77690728	GA	77690044	684
4043A_1	18	77691012	77691012	GA	77690044	968
4043A_1	18	77690728	77690728	GA	77690283	445
4043A_1	18	77691012	77691012	GA	77690283	729
4043A_1	11	267825	267825	GA	268203	378
4043A_1	19	29660380	29660380	GA	29661197	817
4043A_1	3	31138281	31138281	GA	31139142	861
4043A_1	3	31138560	31138560	GA	31139142	582
4043A_1	11	60538525	60538525	CA	60537662	863
4043A_1	20	10451385	10451385	GA	10451127	258
4043A_1	20	10451495	10451495	GA	10451127	368
4043A_1	20	37034405	37034405	GC	37033652	753
4043A_1	X	28634645	28634645	GA	28635117	472
4043A_1	X	28634936	28634936	GA	28635117	181
4043A_1	X	34442126	34442126	CA	34441952	174
4043A_1	6	65178216	65178216	CT	65178468	252
4043A_1	6	65178216	65178216	CT	65178153	63
4043A_1	18	34972533	34972533	CA	34973041	508
4043A_1	6	65178216	65178216	CT	65178331	115
4043A_1	6	65178216	65178216	CT	65178469	253
4043A_1	18	77691764	77691764	GT	77692030	266
4043A_1	16	7313578	7313578	GT	7313033	545
4043A_1	X	73912331	73912331	GA	73911571	760
4043A_1	X	73912331	73912331	GA	73912724	393
4043A_1	X	73913331	73913331	GA	73912724	607
4043A_1	X	74331837	74331837	CT	74332219	382
4043A_1	3	160574640	160574640	CG	160574764	124
4043A_1	X	77684185	77684185	GC	77684095	90
4043A_1	11	55586265	55586265	GC	55586981	716
4043A_1	X	78342718	78342718	GA	78342539	179
4043A_1	X	78342718	78342718	GA	78342552	166
4043A_1	16	8494280	8494280	GC	8493456	824
4043A_1	X	78611536	78611536	GA	78610628	908
4043A_1	X	78611536	78611536	GA	78610644	892
4043A_1	X	78773622	78773622	GA	78772853	769
4043A_1	6	65178216	65178216	CT	65178147	69
4043A_1	8	3490845	3490845	GA	3490815	30
4043A_1	6	65178216	65178216	CT	65177929	287
4043A_1	X	81263147	81263147	GC	81262727	420
4043A_1	6	65178216	65178216	CT	65178520	304
4043A_1	X	81287039	81287039	GA	81287598	559
4043A_1	X	85023411	85023411	GA	85023373	38
4043A_1	X	85024343	85024343	GT	85023373	970
4043A_1	11	56334599	56334599	CT	56334977	378
4043A_1	11	56334910	56334910	CA	56334977	67
4043A_1	3	85137600	85137600	GA	85137876	276
4043A_1	X	86312564	86312564	GA	86313487	923
4043A_1	X	86312564	86312564	GA	86313491	927
4043A_1	16	21739249	21739249	CT	21738705	544
4043A_1	6	65178216	65178216	CT	65178433	217
4043A_1	X	126838701	126838701	CA	126838797	96
4043A_1	12	242246	242246	AG	242054	192
4043A_1	X	153650289	153650289	CT	153650162	127
4043A_1	X	153650289	153650289	CT	153650283	6
4043A_1	X	153650289	153650289	CT	153650462	173
4043A_1	X	153650289	153650289	CT	153650632	343
4043A_1	X	153659659	153659659	CT	153659981	322
4043A_1	X	153660585	153660585	CT	153659981	604
4043A_1	8	7005759	7005759	GC	7005436	323
4043A_1	8	7006410	7006410	GA	7005436	974
4043A_1	X	153900688	153900688	CG	153900471	217
4043A_1	X	153900688	153900688	CG	153900473	215
4043A_4	3	173702891	173702891	CT	173703034	143
4043A_4	6	65178216	65178216	CT	65178445	229
4043A_4	8	3823313	3823313	GA	3823539	226
4043A_4	12	28320704	28320704	CT	28320820	116
4043A_4	12	70566745	70566745	GA	70567500	755
4043A_4	18	59616748	59616748	GA	59617380	632
4043A_4	18	59709089	59709089	CG	59709145	56
4043A_4	X	75505689	75505689	TG	75505936	247
4043A_4	X	78612735	78612735	GA	78613588	853
4043A_4	X	78773622	78773622	GA	78774370	748
4043A_4	2	146033614	146033614	AG	146033456	158
4043A_4	3	173702891	173702891	CT	173702579	312
4043A_4	3	192428338	192428338	GA	192427804	534
4043A_4	4	63257268	63257268	AT	63257225	43
4043A_4	6	65178216	65178216	CT	65178037	179
4043A_4	8	2638438	2638438	CG	2638217	221
4043A_4	8	117145528	117145528	AG	117145463	65
4043A_4	9	22052086	22052086	CT	22051965	121
4043A_4	12	648079	648079	CT	647696	383
4043A_4	12	17058657	17058657	GC	17059300	643
4043A_4	12	28335830	28335830	CT	28335770	60
4043A_4	12	72181254	72181254	GC	72182023	769
4043A_4	17	27314719	27314719	CT	27314164	555
4043A_4	17	38412389	38412389	AG	38412225	164
4043A_4	18	21069329	21069329	TA	21068381	948
4043A_4	18	57653422	57653422	GA	57652630	792
4043A_4	18	62000351	62000351	CT	61999851	500
4043A_4	X	80677492	80677492	GA	80677164	328
4043A_4	3	12624727	12624727	CT	12625599	872
4043A_4	3	14776487	14776487	CA	14775931	556
4043A_4	3	14776487	14776487	CA	14775943	544
4043A_4	3	173702891	173702891	CT	173702887	4
4043A_4	3	186788672	186788672	GA	186788422	250
4043A_4	3	186789280	186789280	GA	186788422	858
4043A_4	4	57730607	57730607	GA	57730456	151
4043A_4	5	272500	272500	GT	272220	280
4043A_4	8	3821311	3821311	GA	3820857	454
4043A_4	8	3821745	3821745	GA	3820857	888
4043A_4	10	46073364	46073364	GA	46073797	433
4043A_4	12	55685330	55685330	CA	55685881	551
4043A_4	12	55685698	55685698	CT	55685881	183
4043A_4	12	91804816	91804816	GC	91804100	716
4043A_4	12	118016361	118016361	CG	118016440	79
4043A_4	18	41335386	41335386	CG	41336176	790
4043A_4	18	41335907	41335907	CT	41336176	269
4043A_4	18	52452751	52452751	CT	52453540	789
4043A_4	18	55146302	55146302	GT	55145525	777
4043A_4	18	55146302	55146302	GT	55146936	634
4043A_4	18	57653422	57653422	GA	57652629	793
4043A_4	18	57658766	57658766	GT	57659721	955
4043A_4	18	57660408	57660408	GA	57659721	687
4043A_4	18	59839986	59839986	GC	59840500	514
4043A_4	18	59840899	59840899	GA	59840500	399
4043A_4	18	59840899	59840899	GA	59841323	424
4043A_4	18	62000351	62000351	CT	61999852	499
4043A_4	18	68160235	68160235	GC	68160861	626
4043A_4	18	68161648	68161648	GA	68160861	787
4043A_4	19	3644140	3644140	CT	3644441	301
4043A_4	20	45560236	45560236	CT	45561125	889
4043A_4	X	34707035	34707035	GA	34707122	87
4043A_4	X	65955745	65955745	GC	65955470	275
4043A_4	X	73912331	73912331	GA	73912647	316
4043A_4	X	73913331	73913331	GA	73912647	684
4043A_4	X	77922258	77922258	GT	77922255	3
4043A_4	X	78342718	78342718	GA	78342715	3
4043A_4	X	78343358	78343358	GC	78342715	643
4043A_4	X	81759777	81759777	GT	81759235	542
4043A_4	6	65178216	65178216	CT	65178026	190
4043A_4	8	3821311	3821311	GA	3821241	70
4043A_4	8	3821745	3821745	GA	3821241	504
4043A_4	8	3821311	3821311	GA	3821605	294
4043A_4	8	3821745	3821745	GA	3821605	140
4043A_4	7	62510168	62510168	CA	62510471	303
4043A_4	7	62510573	62510573	GC	62510471	102
4043A_4	8	3596387	3596387	AT	3595996	391
4043A_4	11	40569586	40569586	CG	40569794	208
4043A_4	12	83561498	83561498	CT	83561745	247
4043A_4	12	118016361	118016361	CG	118015681	680
4043A_4	12	122729315	122729315	CT	122729426	111
4043A_4	16	7336608	7336608	GA	7337436	828
4043A_4	11	45977323	45977323	GA	45977010	313
4043A_4	11	45977519	45977519	GA	45977010	509
4043A_4	11	45977606	45977606	GC	45977010	596
4043A_4	14	105316575	105316575	GA	105317065	490
4043A_4	11	103518981	103518981	CT	103519165	184
4043A_4	3	175389014	175389014	CT	175389039	25
4043A_4	18	45599775	45599775	CT	45600595	820
4043A_4	18	45600112	45600112	CA	45600595	483
4043A_4	12	27910895	27910895	AC	27910889	6
4043A_4	18	52452751	52452751	CT	52452598	153
4043A_4	18	52452751	52452751	CT	52452627	124
4043A_4	18	52452751	52452751	CT	52453735	984
4043A_4	3	173702891	173702891	CT	173703142	251
4043A_4	3	173702891	173702891	CT	173702554	337
4043A_4	3	173702891	173702891	CT	173703053	162
4043A_4	18	57666491	57666491	GC	57667334	843
4043A_4	3	173702891	173702891	CT	173703087	196
4043A_4	3	181549934	181549934	TA	181549971	37
4043A_4	12	27910895	27910895	AC	27910877	18
4043A_4	12	27910895	27910895	AC	27910818	77
4043A_4	18	68403833	68403833	GT	68403464	369
4043A_4	18	69394630	69394630	GT	69394335	295
4043A_4	18	69461444	69461444	CT	69461191	253
4043A_4	18	77690728	77690728	GA	77690044	684
4043A_4	18	77691012	77691012	GA	77690044	968
4043A_4	18	77690728	77690728	GA	77690283	445
4043A_4	18	77691012	77691012	GA	77690283	729
4043A_4	18	69133279	69133279	CG	69133350	71
4043A_4	19	29660380	29660380	GA	29661197	817
4043A_4	11	37527151	37527151	GA	37527839	688
4043A_4	11	37527477	37527477	GC	37527839	362
4043A_4	8	40539821	40539821	CT	40540140	319
4043A_4	11	55586265	55586265	GC	55585515	750
4043A_4	11	60538525	60538525	CA	60537662	863
4043A_4	20	4626052	4626052	CA	4625392	660
4043A_4	3	175060969	175060969	GT	175060641	328
4043A_4	20	37034405	37034405	GC	37033627	778
4043A_4	X	28634645	28634645	GA	28635117	472
4043A_4	X	28634936	28634936	GA	28635117	181
4043A_4	X	34442126	34442126	CA	34441952	174
4043A_4	6	65178216	65178216	CT	65178469	253
4043A_4	6	65178216	65178216	CT	65178153	63
4043A_4	18	34972533	34972533	CA	34973041	508
4043A_4	X	65350983	65350983	CT	65351149	166
4043A_4	11	30352936	30352936	CT	30353818	882
4043A_4	11	30353774	30353774	CT	30353818	44
4043A_4	12	648079	648079	CT	648256	177
4043A_4	19	42966593	42966593	CT	42965689	904
4043A_4	6	65178216	65178216	CT	65178331	115
4043A_4	6	65178216	65178216	CT	65178469	253
4043A_4	20	4626052	4626052	CA	4625716	336
4043A_4	X	73912331	73912331	GA	73912724	393
4043A_4	X	73913331	73913331	GA	73912724	607
4043A_4	18	68403833	68403833	GT	68404675	842
4043A_4	X	74331837	74331837	CT	74332219	382
4043A_4	3	124041429	124041429	CT	124040779	650
4043A_4	6	65178216	65178216	CT	65177995	221
4043A_4	12	242246	242246	AG	242485	239
4043A_4	X	77684185	77684185	GC	77684095	90
4043A_4	11	55586265	55586265	GC	55586981	716
4043A_4	3	66999263	66999263	CT	66999192	71
4043A_4	16	8494280	8494280	GC	8493456	824
4043A_4	20	16552259	16552259	TC	16552259	0
4043A_4	X	78773622	78773622	GA	78772854	768
4043A_4	6	65178216	65178216	CT	65178147	69
4043A_4	8	3490845	3490845	GA	3490815	30
4043A_4	6	65178216	65178216	CT	65177929	287
4043A_4	X	81287039	81287039	GA	81287598	559
4043A_4	11	56337172	56337172	CT	56337919	747
4043A_4	11	56337437	56337437	CT	56337919	482
4043A_4	11	56337654	56337654	CT	56337919	265
4043A_4	11	56334599	56334599	CT	56334977	378
4043A_4	3	85137600	85137600	GA	85137963	363
4043A_4	X	86312564	86312564	GA	86313487	923
4043A_4	X	86313377	86313377	GT	86313487	110
4043A_4	X	86313525	86313525	GC	86313487	38
4043A_4	X	86312564	86312564	GA	86313491	927
4043A_4	X	86313377	86313377	GT	86313491	114
4043A_4	X	86313525	86313525	GC	86313491	34
4043A_4	X	86313377	86313377	GT	86313717	340
4043A_4	X	86313525	86313525	GC	86313717	192
4043A_4	X	86339987	86339987	GA	86339991	4
4043A_4	6	65178216	65178216	CT	65178433	217
4043A_4	6	65178216	65178216	CT	65178434	218
4043A_4	X	150273863	150273863	GA	150273788	75
4043A_4	12	242246	242246	AG	242050	196
4043A_4	X	153650289	153650289	CT	153650162	127
4043A_4	19	53812436	53812436	GA	53812056	380
4043A_4	X	153650289	153650289	CT	153650283	6
4043A_4	X	153650289	153650289	CT	153650632	343
4043A_4	X	153659659	153659659	CT	153659981	322
4043A_4	X	153660585	153660585	CT	153659981	604
4043A_4	8	7005759	7005759	GC	7005436	323
4043A_4	8	7006070	7006070	GA	7005436	634
4043A_4	8	7006171	7006171	GA	7005436	735
4043A_4	8	7006410	7006410	GA	7005436	974
4043A_4	19	53812436	53812436	GA	53813013	577
4333	7	115972649	115972649	GT	115972218	431
4333	7	115972828	115972828	GC	115972218	610
4333	11	100959257	100959257	GT	100959087	170
4333	11	102590607	102590607	GA	102591310	703
4333	2	157429838	157429838	CT	157429692	146
4333	2	157429972	157429972	CT	157429692	280
4333	11	103203718	103203718	AG	103203999	281
4856_1	3	115238513	115238513	GC	115239413	900
4856_1	3	152242266	152242266	CT	152243165	899
4856_1	3	152242956	152242956	CG	152243165	209
4856_1	20	60390013	60390013	CT	60390425	412
4856_1	20	61506000	61506000	CT	61505860	140
4856_1	3	125720864	125720864	CG	125721242	378
4856_1	7	38017604	38017604	CT	38018061	457
4856_1	7	38017732	38017732	CA	38018061	329
4856_1	19	11502453	11502453	TA	11502669	216
4856_1	19	17922639	17922639	CG	17922842	203
4856_1	21	25193190	25193190	CT	25193559	369
4856_1	21	25193391	25193391	CT	25193559	168
4856_1	21	25193499	25193499	CT	25193559	60
4856_1	7	35447276	35447276	AT	35446961	315
4856_1	7	35447421	35447421	AC	35446961	460
4856_1	7	35447700	35447700	AG	35446961	739
4856_1	7	56684242	56684242	CG	56684845	603
4856_1	3	85179930	85179930	TG	85180307	377
4856_1	7	42332760	42332760	CT	42333534	774
4856_1	7	42333137	42333137	CG	42333534	397
4856_1	19	24070006	24070006	GA	24069260	746
4856_1	19	24070201	24070201	GT	24069260	941
4856_1	5	23110713	23110713	CG	23111578	865
4856_1	5	23110999	23110999	CG	23111578	579
4856_1	5	23111422	23111422	CT	23111578	156
4856_1	21	25431644	25431644	GC	25431272	372
4856_1	21	25432098	25432098	GA	25431272	826
4856_3	3	144687641	144687641	CT	144687885	244
4856_3	3	152242266	152242266	CT	152243165	899
4856_3	3	152242956	152242956	CG	152243165	209
4856_3	20	60390013	60390013	CT	60390425	412
4856_3	21	25193190	25193190	CT	25193560	370
4856_3	21	25193391	25193391	CT	25193560	169
4856_3	21	25193499	25193499	CT	25193560	61
4856_3	7	55392735	55392735	GC	55392619	116
4856_3	11	84254685	84254685	AT	84254671	14
4856_3	20	61506000	61506000	CT	61505860	140
4856_3	3	125720864	125720864	CG	125721270	406
4856_3	7	38016977	38016977	CA	38017975	998
4856_3	7	38017604	38017604	CT	38017975	371
4856_3	7	38017732	38017732	CA	38017975	243
4856_3	7	38018069	38018069	CT	38017975	94
4856_3	19	11502453	11502453	TA	11502668	215
4856_3	19	17922639	17922639	CG	17922842	203
4856_3	21	14341077	14341077	AC	14340297	780
4856_3	21	25193190	25193190	CT	25193559	369
4856_3	21	25193391	25193391	CT	25193559	168
4856_3	21	25193499	25193499	CT	25193559	60
4856_3	7	35447276	35447276	AT	35446960	316
4856_3	7	35447421	35447421	AC	35446960	461
4856_3	7	35447700	35447700	AG	35446960	740
4856_3	3	85179930	85179930	TG	85180307	377
